date,departamento,departamento_id,vacas,vaquillonas,novillos,novillitos,terneros,terneras,toros,totalcabezas,ternerossuma,novillossuma
"2015-01-01 00:00:00,000","Olavarría","595",289039,70976,15124,31127,107317,105480,13116,630342,212797,46251
"2015-01-01 00:00:00,000","General Villegas","392",119515,52067,36398,31552,56621,54974,5055,354535,111595,67950
"2015-01-01 00:00:00,000","Trenque Lauquen","826",109809,46672,14307,37992,37501,42223,3285,296511,79724,52299
"2015-01-01 00:00:00,000","Pila","630",123758,35004,1894,7205,37110,41314,4877,255366,78424,9099
"2015-01-01 00:00:00,000","Navarro","574",58195,20637,4328,6126,17097,20893,2139,133211,37990,10454
"2015-01-01 00:00:00,000","Capitán Sarmiento","140",166,63,9,18,48,45,9,355,93,27
"2015-01-01 00:00:00,000","Zárate","882",9701,4054,2374,3707,4179,4460,507,29263,8639,6081
"2015-01-01 00:00:00,000","9 de Julio","588",108198,29000,3910,11211,39489,47407,3902,251035,86896,15121
"2015-01-01 00:00:00,000","Pergamino","623",44648,11338,3146,4542,16341,19159,1864,103856,35500,7688
"2015-01-01 00:00:00,000","Tres Lomas","847",21314,9064,7682,6925,7378,7613,692,60903,14991,14607
"2015-01-01 00:00:00,000","Puán","651",115343,38804,16511,17902,38213,37940,6424,270864,76153,34413
"2015-01-01 00:00:00,000","Guaminí","399",94827,32448,15376,17947,41846,45059,4077,254793,86905,33323
"2015-01-01 00:00:00,000","Necochea","581",74957,17751,6896,4107,22842,27133,3544,161521,49975,11003
"2015-01-01 00:00:00,000","Pehuajó","609",93670,27930,16319,15837,35241,34717,3331,226521,69958,32156
"2015-01-01 00:00:00,000","Villarino","875",157203,53835,18375,21835,46993,50008,7099,358363,97001,40210
"2015-01-01 00:00:00,000","Tres Arroyos","833",88252,24727,11080,8379,34122,37100,3689,210327,71222,19459
"2015-01-01 00:00:00,000","Adolfo Gonzales Chaves","014",95222,25070,2499,5324,32261,34484,4951,202034,66745,7823
"2015-01-01 00:00:00,000","Presidente Perón","648",727,125,5,21,154,195,26,1294,349,26
"2015-01-01 00:00:00,000","General Viamonte","385",47346,10908,1140,6875,20931,20190,1892,108541,41121,8015
"2015-01-01 00:00:00,000","Pilar","638",1354,500,48,75,305,466,59,2968,771,123
"2015-01-01 00:00:00,000","25 de Mayo","854",116950,39960,5916,16882,55882,53464,5647,292283,109346,22798
"2015-01-01 00:00:00,000","Merlo","539",279,54,3,5,45,46,14,447,91,8
"2015-01-01 00:00:00,000","Moreno","560",102,25,2,10,22,34,10,217,56,12
"2015-01-01 00:00:00,000","San Vicente","778",28259,6253,1169,1692,8870,10314,1427,59428,19184,2861
"2015-01-01 00:00:00,000","Maipú","511",106971,23103,5129,7744,31182,37161,4685,221954,68343,12873
"2015-01-01 00:00:00,000","Las Flores","455",139137,27786,2624,5928,42648,47283,6577,276618,89931,8552
"2015-01-01 00:00:00,000","San Pedro","770",14969,6299,4311,7914,10276,6751,764,47759,17027,12225
"2015-01-01 00:00:00,000","Saladillo","707",82942,29047,4438,16899,38782,39696,4348,217066,78478,21337
"2015-01-01 00:00:00,000","Leandro N. Alem","462",30072,9618,1060,5997,10561,11038,1377,70200,21599,7057
"2015-01-01 00:00:00,000","San Nicolás","763",8137,1537,56,689,2585,2799,311,16328,5384,745
"2015-01-01 00:00:00,000","Magdalena","505",93623,21247,3440,7904,29289,33338,4049,196939,62627,11344
"2015-01-01 00:00:00,000","Salliqueló","721",16152,6326,10843,8853,8260,5193,1064,53624,13453,19696
"2015-01-01 00:00:00,000","San Fernando","749",3776,1078,361,210,811,1105,149,7784,1916,571
"2015-01-01 00:00:00,000","Luján","497",13116,5649,416,1007,3844,4584,550,29906,8428,1423
"2015-01-01 00:00:00,000","Salto","714",15176,4236,791,3324,7933,8772,608,41679,16705,4115
"2015-01-01 00:00:00,000","Lincoln","469",168541,52276,12489,21501,59829,60899,7874,384479,120728,33990
"2015-01-01 00:00:00,000","San Andrés de Giles","728",21924,6280,2427,5056,8970,8407,1156,53657,17377,7483
"2015-01-01 00:00:00,000","San Cayetano","742",47019,11171,787,8061,18408,19113,1879,107143,37521,8848
"2015-01-01 00:00:00,000","Lobería","476",83257,26749,10673,10737,31197,33758,3901,202833,64955,21410
"2015-01-01 00:00:00,000","Lobos","483",53074,18735,2631,7380,22052,24652,1891,133015,46704,10011
"2015-01-01 00:00:00,000","Saavedra","700",73543,28121,7049,11634,24684,25683,4054,175767,50367,18683
"2015-01-01 00:00:00,000","Punta Indio","655",79116,17703,1641,3137,23008,27898,3618,161011,50906,4778
"2015-01-01 00:00:00,000","Mar Chiquita","518",132554,42720,3122,14329,40910,47914,7060,295613,88824,17451
"2015-01-01 00:00:00,000","Roque Pérez","693",44797,9852,2135,4498,19799,18791,2199,101063,38590,6633
"2015-01-01 00:00:00,000","Tornquist","819",81188,32218,9985,15634,25209,27136,3528,196825,52345,25619
"2015-01-01 00:00:00,000","Ramallo","665",11190,3732,1263,4115,9421,7399,528,35626,16820,5378
"2015-01-01 00:00:00,000","Monte","547",54997,17818,3670,9083,17544,19693,2039,126993,37237,12753
"2015-01-01 00:00:00,000","Tordillo","812",55473,15721,4158,5448,20251,20770,2320,124660,41021,9606
"2015-01-01 00:00:00,000","Junín","413",35097,7997,1277,2577,14658,15553,2001,80055,30211,3854
"2015-01-01 00:00:00,000","Tigre","805",97,47,22,2,26,26,9,229,52,24
"2015-01-01 00:00:00,000","Rauch","672",193941,44930,4541,12252,56345,64502,8068,392736,120847,16793
"2015-01-01 00:00:00,000","Pellegrini","616",23452,8852,12182,8657,12577,9842,1097,73924,22419,20839
"2015-01-01 00:00:00,000","La Matanza","427",642,259,44,103,246,181,26,1436,427,147
"2015-01-01 00:00:00,000","Tapalqué","798",177193,36132,3828,9315,47828,55974,7235,345651,103802,13143
"2015-01-01 00:00:00,000","Rivadavia","679",49381,26335,27495,47146,29603,17512,1946,187327,47115,74641
"2015-01-01 00:00:00,000","Mercedes","532",33888,9533,2914,2426,10835,12257,1346,74621,23092,5340
"2015-01-01 00:00:00,000","Rojas","686",24859,7886,1952,6281,11944,11156,1142,64432,23100,8233
"2015-01-01 00:00:00,000","Tandil","791",121730,45207,13171,19258,46346,51488,5175,307517,97834,32429
"2015-01-01 00:00:00,000","La Plata","441",22914,6423,646,1345,9644,11360,1052,55100,21004,1991
"2015-01-01 00:00:00,000","Marcos Paz","525",11973,3669,586,4183,3169,4443,352,29649,7612,4769
"2015-01-01 00:00:00,000","Suipacha","784",35605,9976,1899,3208,8567,10410,1486,72994,18977,5107
"2015-01-01 00:00:00,000","Laprida","448",142228,38872,13316,14919,49044,52046,6265,319692,101090,28235
"2015-01-01 00:00:00,000","San Antonio de Areco","735",10748,2411,1295,1420,6224,5040,651,26605,11264,2715
"2015-01-01 00:00:00,000","Hipólito Yrigoyen","406",25754,11530,4566,11148,14781,12062,1062,78184,26843,15714
"2015-01-01 00:00:00,000","General Arenales","294",14261,3457,72,1604,5454,5649,643,31335,11103,1676
"2015-01-01 00:00:00,000","Arrecifes","077",15970,5964,2141,3947,9651,10407,849,49685,20058,6088
"2015-01-01 00:00:00,000","Colón","175",14927,4100,1101,1150,4829,5036,589,31939,9865,2251
"2015-01-01 00:00:00,000","General Paz","343",59295,18152,2443,4249,17051,20917,2217,128190,37968,6692
"2015-01-01 00:00:00,000","Carlos Casares","147",63014,22083,4531,12525,25049,24010,2404,152577,49059,17056
"2015-01-01 00:00:00,000","General Rodríguez","364",7537,1862,485,404,2297,2944,338,16514,5241,889
"2015-01-01 00:00:00,000","Chivilcoy","224",34950,11342,2325,4474,13606,13550,1803,81994,27156,6799
"2015-01-01 00:00:00,000","Berazategui","091",1894,536,1122,721,400,421,111,5226,821,1843
"2015-01-01 00:00:00,000","Ayacucho","042",326916,78202,19056,32837,105213,115454,13013,700932,220667,51893
"2015-01-01 00:00:00,000","General Alvarado","280",23340,6102,872,8667,9181,8994,1129,58098,18175,9539
"2015-01-01 00:00:00,000","Esteban Echeverría","260",117,13,121,1,34,35,12,334,69,122
"2015-01-01 00:00:00,000","General Juan Madariaga","315",110135,29918,10551,16415,36279,39635,4645,250934,75914,26966
"2015-01-01 00:00:00,000","Chascomús","218",176288,59986,6367,17802,54350,62897,7030,393267,117247,24169
"2015-01-01 00:00:00,000","Carlos Tejedor","154",96278,35177,14100,16911,34886,34631,4017,235745,69517,31011
"2015-01-01 00:00:00,000","General Guido","308",109393,20194,1322,4977,29762,36560,4212,213218,66322,6299
"2015-01-01 00:00:00,000","Azul","049",229293,71001,13563,21718,80424,86216,10115,518122,166640,35281
"2015-01-01 00:00:00,000","General La Madrid","322",158252,51730,14957,18497,55727,59860,6240,369396,115587,33454
"2015-01-01 00:00:00,000","Campana","126",8166,1808,595,1025,2586,2332,336,16594,4918,1620
"2015-01-01 00:00:00,000","Exaltación de la Cruz","266",9613,3351,493,1409,2285,3031,577,21505,5316,1902
"2015-01-01 00:00:00,000","Bahía Blanca","056",35684,17512,3205,7330,12011,12793,1808,91125,24804,10535
"2015-01-01 00:00:00,000","General Lavalle","336",89002,23509,7175,7361,25104,29133,4057,189370,54237,14536
"2015-01-01 00:00:00,000","Benito Juárez","084",193002,43064,11941,11858,58463,69220,8121,406426,127683,23799
"2015-01-01 00:00:00,000","Castelli","168",71229,22884,3811,4393,19505,23134,2713,151298,42639,8204
"2015-01-01 00:00:00,000","Florencio Varela","274",2319,680,10,443,581,565,99,4681,1146,453
"2015-01-01 00:00:00,000","Balcarce","063",105602,35976,14379,13670,39218,42620,5587,260454,81838,28049
"2015-01-01 00:00:00,000","José M. Ezeiza","270",730,209,101,132,172,257,37,1723,429,233
"2015-01-01 00:00:00,000","Patagones","602",109371,34415,15883,19294,34353,36472,5312,257219,70825,35177
"2015-01-01 00:00:00,000","Carmen de Areco","161",30449,14773,2461,2658,10257,12113,1249,75816,22370,5119
"2015-01-01 00:00:00,000","General Las Heras","329",34558,11577,2134,2768,10526,12970,1253,78230,23496,4902
"2015-01-01 00:00:00,000","Chacabuco","210",36368,10519,1667,6101,16178,14391,1364,84801,30569,7768
"2015-01-01 00:00:00,000","Escobar","252",3337,1058,120,221,858,1021,148,6926,1879,341
"2015-01-01 00:00:00,000","Baradero","070",16286,5126,3358,3226,7147,7285,717,43283,14432,6584
"2015-01-01 00:00:00,000","Bolívar","105",153167,43137,9633,24754,52283,58714,7730,355849,110997,34387
"2015-01-01 00:00:00,000","Alberti","021",15933,3508,1086,1698,6646,6665,770,36325,13311,2784
"2015-01-01 00:00:00,000","Dolores","238",76389,21515,3009,6670,23824,26036,3361,163016,49860,9679
"2015-01-01 00:00:00,000","Coronel de Marina Leonardo Rosales","182",18063,4600,1258,1990,4572,5486,936,37819,10058,3248
"2015-01-01 00:00:00,000","Capitán Sarmiento","140",5326,2235,216,906,2781,2408,327,13826,5189,1122
"2015-01-01 00:00:00,000","Coronel Pringles","196",136771,31646,5128,12802,44642,48553,6063,289516,93195,17930
"2015-01-01 00:00:00,000","Daireaux","231",84688,26930,7735,9861,27461,30943,3615,194715,58404,17596
"2015-01-01 00:00:00,000","Cañuelas","134",52874,11523,1180,3442,15392,18663,2446,108791,34055,4622
"2015-01-01 00:00:00,000","Almirante Brown","028",163,29,2,9,59,59,9,330,118,11
"2015-01-01 00:00:00,000","General Belgrano","301",57490,19531,3200,6811,18993,23827,2652,137338,42820,10011
"2015-01-01 00:00:00,000","Adolfo Alsina","007",91565,31619,22107,17817,33187,31401,3631,229541,64588,39924
"2015-01-01 00:00:00,000","Coronel Dorrego","189",78589,26742,9199,11619,26770,27213,3532,184107,53983,20818
"2015-01-01 00:00:00,000","General Alvear","287",138785,41897,5667,11802,40666,47395,5631,298572,88061,17469
"2015-01-01 00:00:00,000","Florentino Ameghino","277",49120,14817,3369,6250,21166,21205,1981,117947,42371,9619
"2015-01-01 00:00:00,000","General Pinto","351",65309,21739,4892,7326,24005,26501,2716,154984,50506,12218
"2015-01-01 00:00:00,000","Coronel Suárez","203",124732,41641,16809,16962,49555,51723,7492,311082,101278,33771
"2015-01-01 00:00:00,000","Bragado","112",38770,8647,1927,3734,13912,14238,1487,83041,28150,5661
"2015-01-01 00:00:00,000","Brandsen","119",62286,13144,2118,2654,17715,21407,2632,125648,39122,4772
"2015-01-01 00:00:00,000","Berisso","098",1637,254,762,289,419,403,60,3808,822,1051
"2015-01-01 00:00:00,000","Ensenada","245",327,83,133,232,107,99,14,987,206,365
"2015-01-01 00:00:00,000","General Pueyrredón","357",18240,6989,3836,2945,6757,6883,906,46682,13640,6781
"2013-01-01 00:00:00,000","Pellegrini","616",23640,12052,18141,9482,12097,7999,1083,80396,20096,27623
"2013-01-01 00:00:00,000","Coronel Dorrego","189",77827,28813,11705,9235,27955,27649,3880,186758,55604,20940
"2013-01-01 00:00:00,000","Capitán Sarmiento","140",5191,2132,179,1015,2919,2189,371,13266,5108,1194
"2013-01-01 00:00:00,000","Arrecifes","077",13913,3000,2946,2051,9869,8487,767,39651,18356,4997
"2013-01-01 00:00:00,000","Salliqueló","721",17777,7758,13017,7904,10322,5502,829,58289,15824,20921
"2013-01-01 00:00:00,000","Saladillo","707",82285,29030,6026,14591,42952,40689,5099,218409,83641,20617
"2013-01-01 00:00:00,000","Tres Arroyos","833",90142,24633,10838,7717,37091,38381,3797,213889,75472,18555
"2013-01-01 00:00:00,000","San Cayetano","742",44021,13222,77,8553,18298,18886,2441,106086,37184,8630
"2013-01-01 00:00:00,000","Florentino Ameghino","277",45871,13178,3406,4977,17312,18604,2248,106888,35916,8383
"2013-01-01 00:00:00,000","Brandsen","119",57208,16209,1523,3135,17502,20501,2635,121712,38003,4658
"2013-01-01 00:00:00,000","Tres Lomas","847",21294,9517,9146,8851,10649,8144,724,65820,18793,17997
"2013-01-01 00:00:00,000","Bolívar","105",148368,43898,10825,23865,53703,58473,7430,351332,112176,34690
"2013-01-01 00:00:00,000","San Antonio de Areco","735",10249,2554,898,1806,5925,4568,575,25218,10493,2704
"2013-01-01 00:00:00,000","Coronel Pringles","196",124061,38137,4964,11141,42272,46840,7541,279524,89112,16105
"2013-01-01 00:00:00,000","Navarro","574",57430,23175,4441,7333,19746,20181,2026,134767,39927,11774
"2013-01-01 00:00:00,000","Adolfo Alsina","007",88337,33245,23354,19128,33862,33213,3679,234169,67075,42482
"2013-01-01 00:00:00,000","Zárate","882",9509,4003,1577,2269,3680,3700,1020,25778,7380,3846
"2013-01-01 00:00:00,000","Necochea","581",71858,18659,6447,4033,23066,27477,3990,159941,50543,10480
"2013-01-01 00:00:00,000","Coronel Suárez","203",124848,36582,15089,18467,57281,55099,7031,312215,112380,33556
"2013-01-01 00:00:00,000","Villarino","875",135867,48317,15756,17937,40814,43207,6508,310799,84021,33693
"2013-01-01 00:00:00,000","Salto","714",16409,3649,2169,2057,9021,8745,811,42585,17766,4226
"2013-01-01 00:00:00,000","9 de Julio","588",102906,30610,5076,12210,39646,44613,4733,244761,84259,17286
"2013-01-01 00:00:00,000","Alberti","021",15541,4398,1048,3114,7630,5885,1347,37218,13515,4162
"2013-01-01 00:00:00,000","Bragado","112",38339,8389,1907,2936,15365,14618,1751,82558,29983,4843
"2013-01-01 00:00:00,000","Coronel de Marina Leonardo Rosales","182",16552,5140,887,1865,3764,4896,778,35014,8660,2752
"2013-01-01 00:00:00,000","Olavarría","595",270668,76861,12345,23145,93731,99041,13864,594965,192772,35490
"2013-01-01 00:00:00,000","25 de Mayo","854",115116,38471,5390,19875,51470,54028,6258,293166,105498,25265
"2013-01-01 00:00:00,000","Cañuelas","134",50046,15638,968,3345,13946,17858,2513,108226,31804,4313
"2013-01-01 00:00:00,000","Almirante Brown","028",189,39,1,10,40,62,12,375,102,11
"2013-01-01 00:00:00,000","Pehuajó","609",82669,24484,21106,14422,34385,33651,3856,213839,68036,35528
"2013-01-01 00:00:00,000","Pergamino","623",44043,11093,3249,3760,17237,18382,2490,101399,35619,7009
"2013-01-01 00:00:00,000","Carmen de Areco","161",30651,14296,3443,4004,8638,10079,1151,73703,18717,7447
"2013-01-01 00:00:00,000","Ayacucho","042",310293,72154,18631,29855,104532,112532,13664,669661,217064,48486
"2013-01-01 00:00:00,000","Roque Pérez","693",45429,8684,2779,4891,25915,22813,2411,109820,48728,7670
"2013-01-01 00:00:00,000","Tandil","791",112652,46692,13891,14724,46214,45035,4604,282633,91249,28615
"2013-01-01 00:00:00,000","Balcarce","063",104046,33231,13023,11247,39959,41178,6348,250251,81137,24270
"2013-01-01 00:00:00,000","Ramallo","665",10205,4157,1793,4045,7749,5562,462,31786,13311,5838
"2013-01-01 00:00:00,000","Carlos Tejedor","154",87647,30729,16487,12961,30921,34018,3743,219603,64939,29448
"2013-01-01 00:00:00,000","Castelli","168",64574,21948,3589,5024,16986,20951,2899,139936,37937,8613
"2013-01-01 00:00:00,000","Berazategui","091",1949,433,924,330,490,336,101,4409,826,1254
"2013-01-01 00:00:00,000","Punta Indio","655",75576,20305,1721,3367,20133,24950,3634,154503,45083,5088
"2013-01-01 00:00:00,000","San Pedro","770",15290,5300,5432,7120,7176,5778,834,45532,12954,12552
"2013-01-01 00:00:00,000","Rauch","672",190810,42509,4291,12048,54394,66700,7682,390740,121094,16339
"2013-01-01 00:00:00,000","Baradero","070",16247,5067,3011,3660,6539,7235,795,43250,13774,6671
"2013-01-01 00:00:00,000","Rojas","686",26939,7790,5517,3398,13087,11442,1449,67977,24529,8915
"2013-01-01 00:00:00,000","Patagones","602",93601,35623,18010,20313,30457,31657,5067,235928,62114,38323
"2013-01-01 00:00:00,000","Rivadavia","679",43163,20055,24293,45165,27067,17267,1596,168806,44334,69458
"2013-01-01 00:00:00,000","San Vicente","778",27244,6325,903,2319,8177,10452,1364,59059,18629,3222
"2013-01-01 00:00:00,000","Benito Juárez","084",178316,47148,12514,11025,56916,63194,8787,384178,120110,23539
"2013-01-01 00:00:00,000","Suipacha","784",34048,11684,2666,2588,8724,10117,1386,72606,18841,5254
"2013-01-01 00:00:00,000","Trenque Lauquen","826",102137,44251,19012,29840,37706,39724,3300,277988,77430,48852
"2013-01-01 00:00:00,000","Chacabuco","210",39472,10838,2744,6055,14936,15437,1430,91413,30373,8799
"2013-01-01 00:00:00,000","Campana","126",7805,1889,489,794,2415,2378,301,16034,4793,1283
"2013-01-01 00:00:00,000","Pila","630",125963,32405,2082,6125,32640,38643,4827,248688,71283,8207
"2013-01-01 00:00:00,000","Tornquist","819",71927,27055,6373,13410,20102,22889,4227,168770,42991,19783
"2013-01-01 00:00:00,000","San Fernando","749",4283,1001,194,343,1265,1400,181,8802,2665,537
"2013-01-01 00:00:00,000","Saavedra","700",72807,21939,4857,10237,24596,26897,3838,167472,51493,15094
"2013-01-01 00:00:00,000","Pilar","638",1697,671,86,288,427,571,74,3958,998,374
"2013-01-01 00:00:00,000","Tordillo","812",49948,14467,2623,3376,12412,17348,2466,107576,29760,5999
"2013-01-01 00:00:00,000","Carlos Casares","147",58795,18820,9266,11145,21814,21756,3131,144669,43570,20411
"2013-01-01 00:00:00,000","Tapalqué","798",170331,34465,4102,8972,46495,59353,7417,343993,105848,13074
"2013-01-01 00:00:00,000","Chivilcoy","224",36356,11384,3411,4563,14985,14776,2051,87317,29761,7974
"2013-01-01 00:00:00,000","Azul","049",217430,66994,13145,26454,74259,82254,10674,499205,156513,39599
"2013-01-01 00:00:00,000","Berisso","098",1613,345,787,152,406,296,63,3552,702,939
"2013-01-01 00:00:00,000","San Nicolás","763",8176,1407,87,1027,2816,3071,338,17177,5887,1114
"2013-01-01 00:00:00,000","Chascomús","218",161559,53169,5392,15274,50414,55978,7636,354986,106392,20666
"2013-01-01 00:00:00,000","Tigre","805",235,38,3,16,76,64,9,429,140,19
"2013-01-01 00:00:00,000","Puán","651",107105,33357,11666,15836,34973,36268,5826,246326,71241,27502
"2013-01-01 00:00:00,000","Bahía Blanca","056",28443,13596,2066,5721,8802,9633,1638,70730,18435,7787
"2013-01-01 00:00:00,000","Presidente Perón","648",727,135,8,2,232,236,26,1370,468,10
"2013-01-01 00:00:00,000","San Andrés de Giles","728",21561,7398,2583,6100,8213,8700,1090,56132,16913,8683
"2013-01-01 00:00:00,000","Colón","175",13689,3076,2258,1811,5489,5584,719,32721,11073,4069
"2013-01-01 00:00:00,000","Magdalena","505",83554,22395,3850,5810,27726,31551,3896,182607,59277,9660
"2013-01-01 00:00:00,000","Mar Chiquita","518",132043,41636,2540,11030,42987,50072,7108,294501,93059,13570
"2013-01-01 00:00:00,000","Guaminí","399",89101,35335,15833,20421,34903,37754,5015,241213,72657,36254
"2013-01-01 00:00:00,000","Escobar","252",3528,1084,145,354,1085,899,170,7079,1984,499
"2013-01-01 00:00:00,000","General Pinto","351",58445,21047,6107,6427,20601,22632,3016,140306,43233,12534
"2013-01-01 00:00:00,000","La Plata","441",21625,6089,1021,1206,11173,11876,1024,54717,23049,2227
"2013-01-01 00:00:00,000","General La Madrid","322",150898,47267,11734,14751,52235,55310,7286,342556,107545,26485
"2013-01-01 00:00:00,000","Exaltación de la Cruz","266",8491,2099,73,1188,3059,2840,519,18050,5899,1261
"2013-01-01 00:00:00,000","Lobos","483",52390,17549,3706,6532,22194,24296,2222,130991,46490,10238
"2013-01-01 00:00:00,000","Merlo","539",255,51,3,3,49,65,14,456,114,6
"2013-01-01 00:00:00,000","Maipú","511",99261,24462,3510,6679,27779,32342,4422,203018,60121,10189
"2013-01-01 00:00:00,000","Esteban Echeverría","260",179,50,140,6,45,60,26,521,105,146
"2013-01-01 00:00:00,000","Las Flores","455",135254,33245,2748,5815,43416,46265,6088,275680,89681,8563
"2013-01-01 00:00:00,000","Laprida","448",136922,38397,13066,13563,43435,50028,6989,308993,93463,26629
"2013-01-01 00:00:00,000","General Guido","308",100638,19302,2037,3614,26607,31699,4307,193296,58306,5651
"2013-01-01 00:00:00,000","General Viamonte","385",47983,10966,1338,5717,19433,19037,2133,106211,38470,7055
"2013-01-01 00:00:00,000","Ensenada","245",210,51,127,53,80,64,10,579,144,180
"2013-01-01 00:00:00,000","General Alvarado","280",22305,6861,828,7234,10795,8163,1429,54983,18958,8062
"2013-01-01 00:00:00,000","Lobería","476",83251,24832,12003,8945,33046,33613,5801,202058,66659,20948
"2013-01-01 00:00:00,000","Mercedes","532",31053,10560,2113,3211,10325,12143,1527,72750,22468,5324
"2013-01-01 00:00:00,000","General Paz","343",53519,17317,1255,5031,13940,18977,2156,117232,32917,6286
"2013-01-01 00:00:00,000","General Belgrano","301",54166,21364,2692,5987,21834,23271,3577,134328,45105,8679
"2013-01-01 00:00:00,000","Florencio Varela","274",2234,866,51,470,763,607,106,4941,1370,521
"2013-01-01 00:00:00,000","General Villegas","392",111194,45229,33608,28737,52753,47056,5613,318493,99809,62345
"2013-01-01 00:00:00,000","General Alvear","287",132393,40213,4925,9512,40124,48591,6544,290769,88715,14437
"2013-01-01 00:00:00,000","Hipólito Yrigoyen","406",25341,12137,10171,9222,12557,12171,1249,82462,24728,19393
"2013-01-01 00:00:00,000","Moreno","560",160,44,2,7,54,61,9,344,115,9
"2013-01-01 00:00:00,000","José M. Ezeiza","270",1054,244,125,208,294,312,41,2296,606,333
"2013-01-01 00:00:00,000","General Arenales","294",13669,3002,114,1900,4543,4743,745,28916,9286,2014
"2013-01-01 00:00:00,000","General Lavalle","336",78278,21252,4695,6904,20293,26958,3710,168755,47251,11599
"2013-01-01 00:00:00,000","Lincoln","469",168420,47057,12049,22713,60652,65023,7881,388166,125675,34762
"2013-01-01 00:00:00,000","Luján","497",12404,5154,340,963,3687,4806,618,29091,8493,1303
"2013-01-01 00:00:00,000","General Rodríguez","364",8142,2048,744,514,1841,2388,317,16541,4229,1258
"2013-01-01 00:00:00,000","Daireaux","231",80040,23774,9994,6741,26609,29294,3611,182748,55903,16735
"2013-01-01 00:00:00,000","La Matanza","427",856,342,38,328,374,225,39,2053,599,366
"2013-01-01 00:00:00,000","Capitán Sarmiento","140",334,76,23,63,46,77,11,661,123,86
"2013-01-01 00:00:00,000","Junín","413",34786,8008,1115,3339,13001,15823,2100,80994,28824,4454
"2013-01-01 00:00:00,000","Marcos Paz","525",11976,4182,1130,2405,8311,4153,386,28385,12464,3535
"2013-01-01 00:00:00,000","Adolfo Gonzales Chaves","014",90109,25127,4160,4306,28179,31588,4811,191689,59767,8466
"2013-01-01 00:00:00,000","Dolores","238",72288,22050,2345,4428,20007,21320,3324,147075,41327,6773
"2013-01-01 00:00:00,000","General Juan Madariaga","315",106295,28168,8975,13531,34378,39420,4900,240709,73798,22506
"2013-01-01 00:00:00,000","General Las Heras","329",33637,12182,1793,3498,9867,11965,1415,76455,21832,5291
"2013-01-01 00:00:00,000","Leandro N. Alem","462",28316,10066,2928,4545,11088,11404,1267,69930,22492,7473
"2013-01-01 00:00:00,000","Monte","547",52250,16962,2925,7430,16667,20993,2504,124057,37660,10355
"2013-01-01 00:00:00,000","General Pueyrredón","357",18206,5504,3283,2180,6673,7386,905,44850,14059,5463
"2014-01-01 00:00:00,000","Florencio Varela","274",2202,714,82,340,495,524,87,4473,1019,422
"2014-01-01 00:00:00,000","General Arenales","294",14878,3632,80,1871,4634,5141,695,31438,9775,1951
"2014-01-01 00:00:00,000","Leandro N. Alem","462",29647,9196,2846,3445,10892,11160,1279,68733,22052,6291
"2014-01-01 00:00:00,000","Carmen de Areco","161",30197,12761,2492,2674,10585,13320,1167,75931,23905,5166
"2014-01-01 00:00:00,000","Salto","714",15967,5522,1542,4315,7666,8507,721,45081,16173,5857
"2014-01-01 00:00:00,000","Lobos","483",52957,19623,3338,6845,22022,23614,1957,131948,45636,10183
"2014-01-01 00:00:00,000","Saavedra","700",74639,24738,5192,10590,24396,26272,4079,171782,50668,15782
"2014-01-01 00:00:00,000","Salliqueló","721",17821,8728,10044,8736,6378,3254,915,52752,9632,18780
"2014-01-01 00:00:00,000","Rojas","686",26613,8182,3471,4746,11587,10229,1385,64855,21816,8217
"2014-01-01 00:00:00,000","Carlos Tejedor","154",92506,35774,13133,15007,35553,36791,3858,233860,72344,28140
"2014-01-01 00:00:00,000","Saladillo","707",82661,30833,4924,17551,38452,38846,3952,217613,77298,22475
"2014-01-01 00:00:00,000","General Alvarado","280",21939,7548,2095,6818,10274,9231,958,57820,19505,8913
"2014-01-01 00:00:00,000","Lincoln","469",168784,47237,11802,19056,63762,66064,8155,387162,129826,30858
"2014-01-01 00:00:00,000","Roque Pérez","693",47162,8373,1415,6278,24179,22121,2584,110054,46300,7693
"2014-01-01 00:00:00,000","Lobería","476",83199,24785,10520,11687,32164,34570,4266,203597,66734,22207
"2014-01-01 00:00:00,000","General Alvear","287",136303,44969,5869,11770,47205,51137,6072,307257,98342,17639
"2014-01-01 00:00:00,000","Rivadavia","679",44396,27127,23835,49023,26135,17874,1810,181939,44009,72858
"2014-01-01 00:00:00,000","Capitán Sarmiento","140",5256,2512,279,627,2547,2015,333,13037,4562,906
"2014-01-01 00:00:00,000","Cañuelas","134",51669,15857,1333,2640,16681,18200,2422,110321,34881,3973
"2014-01-01 00:00:00,000","Carlos Casares","147",60318,19087,5124,12499,21423,23850,2489,147217,45273,17623
"2014-01-01 00:00:00,000","Exaltación de la Cruz","266",9170,2229,70,986,2892,2746,615,18562,5638,1056
"2014-01-01 00:00:00,000","Rauch","672",198316,48932,6702,11462,64497,70944,7859,415159,135441,18164
"2014-01-01 00:00:00,000","Brandsen","119",60982,15809,1462,2260,20617,24413,2763,132102,45030,3722
"2014-01-01 00:00:00,000","Pellegrini","616",22737,9023,9275,10540,10167,9139,1055,70908,19306,19815
"2014-01-01 00:00:00,000","Coronel Dorrego","189",82638,26417,10141,12052,29493,30293,3612,195446,59786,22193
"2014-01-01 00:00:00,000","Mercedes","532",32942,10474,2369,3212,11570,11950,1577,74474,23520,5581
"2014-01-01 00:00:00,000","Ensenada","245",210,16,72,224,80,71,10,674,151,296
"2014-01-01 00:00:00,000","Pehuajó","609",89085,25589,16341,14513,37347,34171,3760,217630,71518,30854
"2014-01-01 00:00:00,000","Coronel Pringles","196",135290,35347,4608,13644,44663,47979,6230,291077,92642,18252
"2014-01-01 00:00:00,000","Escobar","252",3703,1030,224,290,1074,1086,190,7609,2160,514
"2014-01-01 00:00:00,000","Olavarría","595",300665,73374,12960,25988,104619,110306,15811,649410,214925,38948
"2014-01-01 00:00:00,000","Coronel de Marina Leonardo Rosales","182",17930,5456,580,2182,4507,5293,844,37578,9800,2762
"2014-01-01 00:00:00,000","9 de Julio","588",107427,31485,4853,11891,38700,44371,4501,248899,83071,16744
"2014-01-01 00:00:00,000","Monte","547",54681,15543,2652,10389,18978,20353,2100,126071,39331,13041
"2014-01-01 00:00:00,000","Dolores","238",76092,21505,4175,4523,26461,27336,3223,164190,53797,8698
"2014-01-01 00:00:00,000","Necochea","581",71823,19098,6312,5735,25929,27747,3969,162431,53676,12047
"2014-01-01 00:00:00,000","Coronel Suárez","203",125980,40661,20485,16624,51816,54589,7176,320104,106405,37109
"2014-01-01 00:00:00,000","Navarro","574",59088,23438,3336,7050,19744,20697,2051,136357,40441,10386
"2014-01-01 00:00:00,000","Merlo","539",278,64,4,6,40,49,12,462,89,10
"2014-01-01 00:00:00,000","Patagones","602",98406,33941,15191,17712,31648,31630,5004,233514,63278,32903
"2014-01-01 00:00:00,000","Marcos Paz","525",12157,4665,2273,2329,6344,4994,384,31796,11338,4602
"2014-01-01 00:00:00,000","Colón","175",13869,3509,1145,1415,4658,5763,613,32077,10421,2560
"2014-01-01 00:00:00,000","Luján","497",13060,4401,322,1024,4216,5243,782,30075,9459,1346
"2014-01-01 00:00:00,000","José M. Ezeiza","270",821,128,134,86,263,289,40,1787,552,220
"2014-01-01 00:00:00,000","Ramallo","665",10158,3849,2400,3880,8087,6781,457,34306,14868,6280
"2014-01-01 00:00:00,000","Castelli","168",68733,24439,4238,4182,23544,26268,2949,157077,49812,8420
"2014-01-01 00:00:00,000","Magdalena","505",90915,21854,3645,5650,31082,34380,3686,194510,65462,9295
"2014-01-01 00:00:00,000","Punta Indio","655",79889,17669,1420,2878,23377,26415,3683,158369,49792,4298
"2014-01-01 00:00:00,000","Chacabuco","210",37620,10254,1724,7107,16250,14969,1456,88099,31219,8831
"2014-01-01 00:00:00,000","Pergamino","623",44518,10508,3210,4740,17560,20051,2331,105409,37611,7950
"2014-01-01 00:00:00,000","Puán","651",112448,36603,11023,15882,36975,39324,5929,260533,76299,26905
"2014-01-01 00:00:00,000","Chascomús","218",171760,51543,5713,13421,59135,65676,7153,380942,124811,19134
"2014-01-01 00:00:00,000","Presidente Perón","648",728,112,9,21,245,219,27,1335,464,30
"2014-01-01 00:00:00,000","Chivilcoy","224",35371,11770,2926,4045,14542,14214,1941,84481,28756,6971
"2014-01-01 00:00:00,000","Pilar","638",1893,704,143,146,533,551,93,4081,1084,289
"2014-01-01 00:00:00,000","Mar Chiquita","518",132430,39688,2928,13105,50376,52902,7141,301096,103278,16033
"2014-01-01 00:00:00,000","Esteban Echeverría","260",94,24,121,5,29,30,13,317,59,126
"2014-01-01 00:00:00,000","Pila","630",133805,35468,2281,6719,44138,48551,5212,280587,92689,9000
"2014-01-01 00:00:00,000","Maipú","511",105754,24695,3897,7480,34510,37843,4815,222327,72353,11377
"2014-01-01 00:00:00,000","Campana","126",7906,1840,802,1002,2521,2267,308,16392,4788,1804
"2014-01-01 00:00:00,000","General Rodríguez","364",8190,2068,586,897,2390,2673,362,17449,5063,1483
"2014-01-01 00:00:00,000","Hipólito Yrigoyen","406",25772,10911,7533,11521,13447,12983,1069,82772,26430,19054
"2014-01-01 00:00:00,000","Ayacucho","042",325352,81925,15785,38503,116171,122908,12842,720223,239079,54288
"2014-01-01 00:00:00,000","Tordillo","812",53864,16680,3899,4495,17359,20430,2456,122254,37789,8394
"2014-01-01 00:00:00,000","Guaminí","399",92236,29992,13824,16937,39010,39526,4403,236444,78536,30761
"2014-01-01 00:00:00,000","Azul","049",223104,70209,11548,22812,84247,89326,9754,516079,173573,34360
"2014-01-01 00:00:00,000","General Juan Madariaga","315",106400,29475,9237,15068,39164,41448,4699,247775,80612,24305
"2014-01-01 00:00:00,000","Tigre","805",122,30,17,12,38,48,10,287,86,29
"2014-01-01 00:00:00,000","Tapalqué","798",181670,37334,2863,11674,60023,64859,7630,370889,124882,14537
"2014-01-01 00:00:00,000","Bahía Blanca","056",32181,15569,2177,5675,11644,12236,1765,81839,23880,7852
"2014-01-01 00:00:00,000","General Lavalle","336",86095,21950,4397,9024,28257,32019,3971,189475,60276,13421
"2014-01-01 00:00:00,000","Tandil","791",117034,45491,14814,17146,45312,49484,5254,298707,94796,31960
"2014-01-01 00:00:00,000","Balcarce","063",105764,33996,12431,12801,43676,43037,6375,257441,86713,25232
"2014-01-01 00:00:00,000","Suipacha","784",41936,10796,1719,3074,9747,10718,1666,80627,20465,4793
"2014-01-01 00:00:00,000","Junín","413",34717,8322,1273,2676,14318,15328,2025,79669,29646,3949
"2014-01-01 00:00:00,000","General Las Heras","329",34167,11508,1675,2658,11926,14527,1290,80352,26453,4333
"2014-01-01 00:00:00,000","Baradero","070",16868,5285,2522,3018,8752,6502,777,41474,15254,5540
"2014-01-01 00:00:00,000","Tornquist","819",77387,28034,7024,14212,22053,24483,3325,178948,46536,21236
"2014-01-01 00:00:00,000","San Vicente","778",27316,7059,657,1660,9705,11461,1408,61022,21166,2317
"2014-01-01 00:00:00,000","General Paz","343",57975,17203,1939,4234,18073,21911,2161,127334,39984,6173
"2014-01-01 00:00:00,000","Trenque Lauquen","826",108887,43322,17320,33057,35185,41540,3484,289150,76725,50377
"2014-01-01 00:00:00,000","Zárate","882",9569,4522,1577,2620,3392,2881,859,24909,6273,4197
"2014-01-01 00:00:00,000","Adolfo Alsina","007",90592,32303,19314,21673,34156,32864,3930,233540,67020,40987
"2014-01-01 00:00:00,000","Villarino","875",146190,47298,16188,19729,43272,46451,6724,329031,89723,35917
"2014-01-01 00:00:00,000","Capitán Sarmiento","140",286,97,21,30,95,106,12,658,201,51
"2014-01-01 00:00:00,000","Alberti","021",16527,3635,1199,2866,7142,7326,1328,40207,14468,4065
"2014-01-01 00:00:00,000","25 de Mayo","854",118531,44983,4882,21028,54520,55995,5973,307387,110515,25910
"2014-01-01 00:00:00,000","General Viamonte","385",49738,10799,1285,6192,19865,20645,2201,111505,40510,7477
"2014-01-01 00:00:00,000","General Pueyrredón","357",17776,7676,4343,1794,6896,7416,921,47342,14312,6137
"2014-01-01 00:00:00,000","Almirante Brown","028",181,27,1,9,34,58,8,342,92,10
"2014-01-01 00:00:00,000","Tres Lomas","847",22033,9608,7106,8448,9472,8614,720,65143,18086,15554
"2014-01-01 00:00:00,000","Florentino Ameghino","277",48481,15527,3575,5162,20535,18846,2210,112647,39381,8737
"2014-01-01 00:00:00,000","General Villegas","392",114485,46721,33048,28988,51390,49141,5811,327335,100531,62036
"2014-01-01 00:00:00,000","General Pinto","351",60254,19938,6364,7929,24071,27142,2625,151394,51213,14293
"2014-01-01 00:00:00,000","Tres Arroyos","833",91240,23291,10797,9135,37660,39216,3485,216380,76876,19932
"2014-01-01 00:00:00,000","Arrecifes","077",15279,3659,1970,4446,10705,9300,762,44716,20005,6416
"2014-01-01 00:00:00,000","Adolfo Gonzales Chaves","014",100382,28473,3064,5626,37030,39884,4874,222187,76914,8690
"2014-01-01 00:00:00,000","La Matanza","427",622,376,85,231,152,169,33,1685,321,316
"2014-01-01 00:00:00,000","Daireaux","231",87693,22240,7372,8921,28362,33008,3634,195876,61370,16293
"2014-01-01 00:00:00,000","San Cayetano","742",46163,10462,490,9569,19072,19608,1845,107745,38680,10059
"2014-01-01 00:00:00,000","La Plata","441",23526,6447,680,2212,11236,11455,1043,56818,22691,2892
"2014-01-01 00:00:00,000","Laprida","448",146411,39214,11465,13387,50678,50896,6813,319082,101574,24852
"2014-01-01 00:00:00,000","San Nicolás","763",8307,1675,25,689,2809,3101,351,17249,5910,714
"2014-01-01 00:00:00,000","San Fernando","749",3702,1149,462,80,1141,1381,144,8299,2522,542
"2014-01-01 00:00:00,000","Bolívar","105",150761,46844,7497,24887,56065,59082,7446,355599,115147,32384
"2014-01-01 00:00:00,000","Berazategui","091",1485,346,388,1149,460,399,84,4250,859,1537
"2014-01-01 00:00:00,000","Bragado","112",39202,7919,1697,4323,14955,15302,1571,85316,30257,6020
"2014-01-01 00:00:00,000","Las Flores","455",142683,31777,3637,6001,53093,55486,6597,301667,108579,9638
"2014-01-01 00:00:00,000","San Antonio de Areco","735",10164,2269,1062,1317,5252,4718,657,24905,9970,2379
"2014-01-01 00:00:00,000","General Belgrano","301",59801,21861,3766,6961,22654,26429,3063,148310,49083,10727
"2014-01-01 00:00:00,000","General Guido","308",108407,23687,2036,4221,36312,40477,4426,223731,76789,6257
"2014-01-01 00:00:00,000","San Pedro","770",15643,6401,4206,5499,8139,5995,751,44490,14134,9705
"2014-01-01 00:00:00,000","San Andrés de Giles","728",21556,7029,2857,5948,9188,8049,1205,54693,17237,8805
"2014-01-01 00:00:00,000","Benito Juárez","084",192221,43717,11223,11391,67027,73571,8532,414226,140598,22614
"2014-01-01 00:00:00,000","Berisso","098",1627,204,681,471,558,333,56,3705,891,1152
"2014-01-01 00:00:00,000","General La Madrid","322",157308,47131,15112,15010,61115,63349,6613,367872,124464,30122
"2012-01-01 00:00:00,000","Saladillo","707",83696,30754,5776,15669,38484,34514,4733,209656,72998,21445
"2012-01-01 00:00:00,000","Saavedra","700",66882,22369,4649,8515,24525,25613,3308,156949,50138,13164
"2012-01-01 00:00:00,000","General Alvear","287",127038,45023,3611,11515,44045,49059,6294,291599,93104,15126
"2012-01-01 00:00:00,000","Lincoln","469",163656,53382,10910,18831,58405,64844,8686,385153,123249,29741
"2012-01-01 00:00:00,000","Carlos Casares","147",63426,22714,7136,15861,23273,22444,3381,157406,45717,22997
"2012-01-01 00:00:00,000","Arrecifes","077",15085,3745,1886,4238,6734,7005,788,39752,13739,6124
"2012-01-01 00:00:00,000","Lobos","483",51370,20385,3383,6368,21824,22141,2165,127953,43965,9751
"2012-01-01 00:00:00,000","Roque Pérez","693",45048,12712,2420,5068,22962,20544,2451,108787,43506,7488
"2012-01-01 00:00:00,000","Tres Lomas","847",22916,11561,7146,10986,9222,8242,789,69882,17464,18132
"2012-01-01 00:00:00,000","Castelli","168",59205,21031,3407,5974,16238,19916,2461,131910,36154,9381
"2012-01-01 00:00:00,000","Rauch","672",186373,48385,4711,10969,59910,67011,8556,393016,126921,15680
"2012-01-01 00:00:00,000","Luján","497",12073,5739,464,943,3526,4549,701,29018,8075,1407
"2012-01-01 00:00:00,000","Patagones","602",91814,31214,18408,17004,30503,32058,4606,227162,62561,35412
"2012-01-01 00:00:00,000","Florentino Ameghino","277",44830,13693,4945,5267,18491,17650,1860,105895,36141,10212
"2012-01-01 00:00:00,000","Rivadavia","679",41407,26764,26970,49012,17836,14607,1597,174964,32443,75982
"2012-01-01 00:00:00,000","Lobería","476",81982,27573,11874,11353,31993,32187,5487,202643,64180,23227
"2012-01-01 00:00:00,000","General Villegas","392",106498,51481,35327,32350,50122,41554,5302,314066,91676,67677
"2012-01-01 00:00:00,000","Carmen de Areco","161",30773,12172,1836,4830,9440,14042,1182,78877,23482,6666
"2012-01-01 00:00:00,000","Rojas","686",27239,7643,3205,4104,10498,10610,1344,64755,21108,7309
"2012-01-01 00:00:00,000","Capitán Sarmiento","140",6035,2036,229,872,3169,3370,386,16298,6539,1101
"2012-01-01 00:00:00,000","Hipólito Yrigoyen","406",25624,13483,8399,13970,9718,10435,1156,83502,20153,22369
"2012-01-01 00:00:00,000","Tres Arroyos","833",91416,26949,10031,6848,38351,39599,3630,218072,77950,16879
"2012-01-01 00:00:00,000","General Alvarado","280",20515,9406,1427,6943,8541,7396,1592,54675,15937,8370
"2012-01-01 00:00:00,000","Carlos Tejedor","154",89823,33424,18088,18391,28566,30727,3772,224952,59293,36479
"2012-01-01 00:00:00,000","Florencio Varela","274",2148,858,75,133,412,552,112,4430,964,208
"2012-01-01 00:00:00,000","Adolfo Gonzales Chaves","014",93189,25673,3541,4116,30469,33741,4735,198736,64210,7657
"2012-01-01 00:00:00,000","San Andrés de Giles","728",20917,7510,3026,6530,6460,7615,1091,54304,14075,9556
"2012-01-01 00:00:00,000","Salliqueló","721",17418,10406,13966,9441,8165,4336,1016,60919,12501,23407
"2012-01-01 00:00:00,000","La Plata","441",20681,6348,823,3304,7155,8394,944,48888,15549,4127
"2012-01-01 00:00:00,000","Berazategui","091",2236,440,546,703,562,543,97,5108,1105,1249
"2012-01-01 00:00:00,000","Guaminí","399",85363,33965,16706,15941,33974,31665,5436,220741,65639,32647
"2012-01-01 00:00:00,000","San Pedro","770",13687,5872,5361,4086,5914,5136,592,39870,11050,9447
"2012-01-01 00:00:00,000","Tordillo","812",48416,15957,2685,3560,17021,21112,2255,115097,38133,6245
"2012-01-01 00:00:00,000","General Las Heras","329",32937,12848,1966,2796,10117,11949,1418,75863,22066,4762
"2012-01-01 00:00:00,000","Benito Juárez","084",169957,51227,12692,12618,59784,68189,8515,391387,127973,25310
"2012-01-01 00:00:00,000","San Vicente","778",27225,8502,784,1707,8895,9687,1507,59099,18582,2491
"2012-01-01 00:00:00,000","San Nicolás","763",8050,1850,75,1195,2784,3060,324,17614,5844,1270
"2012-01-01 00:00:00,000","La Matanza","427",805,284,63,135,244,164,42,1657,408,198
"2012-01-01 00:00:00,000","Suipacha","784",35420,12552,2498,3526,8415,12194,1374,79758,20609,6024
"2012-01-01 00:00:00,000","Tigre","805",80,38,15,4,14,10,6,163,24,19
"2012-01-01 00:00:00,000","Junín","413",35503,10888,2613,2764,14710,15476,2229,84949,30186,5377
"2012-01-01 00:00:00,000","Tandil","791",113654,50021,14650,17893,45380,49533,4773,300057,94913,32543
"2012-01-01 00:00:00,000","General Lavalle","336",76389,18975,4632,5789,23516,27051,3557,163444,50567,10421
"2012-01-01 00:00:00,000","Balcarce","063",105218,37549,15030,11767,42931,42334,5727,259959,85265,26797
"2012-01-01 00:00:00,000","Tapalqué","798",166930,38829,3772,9552,54645,61181,7148,348593,115826,13324
"2012-01-01 00:00:00,000","General Juan Madariaga","315",96682,29926,7797,13874,34471,39110,4488,230987,73581,21671
"2012-01-01 00:00:00,000","Baradero","070",15186,5848,4405,4766,5291,5244,748,41441,10535,9171
"2012-01-01 00:00:00,000","Trenque Lauquen","826",98610,47957,15336,25515,37146,37193,3103,264907,74339,40851
"2012-01-01 00:00:00,000","Azul","049",217568,72915,14006,25151,82598,86225,11893,513983,168823,39157
"2012-01-01 00:00:00,000","Berisso","098",1276,269,859,497,240,272,50,3495,512,1356
"2012-01-01 00:00:00,000","General Arenales","294",13822,2893,191,1898,4399,4923,731,29381,9322,2089
"2012-01-01 00:00:00,000","Cañuelas","134",51342,15998,868,3086,15462,18758,2480,111290,34220,3954
"2012-01-01 00:00:00,000","Salto","714",16840,6520,2413,2646,7715,7594,743,44350,15309,5059
"2012-01-01 00:00:00,000","Leandro N. Alem","462",28947,11998,3069,5192,9911,9701,1171,69779,19612,8261
"2012-01-01 00:00:00,000","Campana","126",6951,2029,700,800,1612,1767,304,14318,3379,1500
"2012-01-01 00:00:00,000","Ramallo","665",9387,3249,2244,2538,4330,3894,431,25637,8224,4782
"2012-01-01 00:00:00,000","General Belgrano","301",58411,21439,6875,5209,21074,24240,3641,144055,45314,12084
"2012-01-01 00:00:00,000","Ayacucho","042",302568,80346,13870,34301,104141,113310,13046,670751,217451,48171
"2012-01-01 00:00:00,000","General La Madrid","322",142360,48771,12487,11023,52092,54717,6813,330888,106809,23510
"2012-01-01 00:00:00,000","Las Flores","455",133190,35490,2244,6179,45187,47970,6101,279144,93157,8423
"2012-01-01 00:00:00,000","San Antonio de Areco","735",10200,3052,1094,1885,5859,5158,642,27189,11017,2979
"2012-01-01 00:00:00,000","General Paz","343",52744,17666,1582,3836,16217,20688,2119,119323,36905,5418
"2012-01-01 00:00:00,000","Tornquist","819",67181,26567,6129,13823,22087,23064,4072,163900,45151,19952
"2012-01-01 00:00:00,000","General Guido","308",107801,20166,1647,3670,31201,34143,4897,206467,65344,5317
"2012-01-01 00:00:00,000","San Cayetano","742",45670,14636,1652,7351,18987,20117,2415,111958,39104,9003
"2012-01-01 00:00:00,000","Bolívar","105",152033,50358,10584,27579,52736,56373,7672,360972,109109,38163
"2012-01-01 00:00:00,000","Laprida","448",134957,40979,13804,13858,47727,53225,6467,316515,100952,27662
"2012-01-01 00:00:00,000","San Fernando","749",4004,1225,173,370,1052,1229,152,8382,2281,543
"2012-01-01 00:00:00,000","Bragado","112",37109,9580,2048,4093,13605,14782,1884,84278,28387,6141
"2012-01-01 00:00:00,000","General Pinto","351",60898,24393,6790,7808,23002,24074,3135,151172,47076,14598
"2012-01-01 00:00:00,000","Bahía Blanca","056",26986,13479,2278,5870,8661,9629,1394,69265,18290,8148
"2012-01-01 00:00:00,000","Brandsen","119",54100,16960,1863,4150,17099,20742,2260,120817,37841,6013
"2012-01-01 00:00:00,000","Coronel Dorrego","189",69185,26545,10454,8595,27740,28072,3424,174347,55812,19049
"2012-01-01 00:00:00,000","Daireaux","231",75474,24591,8057,8099,24325,28349,3356,176275,52674,16156
"2012-01-01 00:00:00,000","Coronel Pringles","196",120669,40756,5574,12772,43389,47317,8120,282525,90706,18346
"2012-01-01 00:00:00,000","Almirante Brown","028",201,37,1,5,69,69,12,394,138,6
"2012-01-01 00:00:00,000","Chascomús","218",163589,52987,5661,13281,52133,58926,7948,361318,111059,18942
"2012-01-01 00:00:00,000","Exaltación de la Cruz","266",8713,2488,197,1006,3020,3143,421,19111,6163,1203
"2012-01-01 00:00:00,000","Mercedes","532",30800,11981,2473,2569,11284,13479,1515,76296,24763,5042
"2012-01-01 00:00:00,000","Capitán Sarmiento","140",328,62,8,67,126,94,15,668,220,75
"2012-01-01 00:00:00,000","Alberti","021",15251,4092,1070,3009,5539,5729,1351,36231,11268,4079
"2012-01-01 00:00:00,000","25 de Mayo","854",117087,43066,5405,20406,48376,50343,6747,293397,98719,25811
"2012-01-01 00:00:00,000","Puán","651",96846,33953,10030,13372,33853,33594,4719,226108,67447,23402
"2012-01-01 00:00:00,000","Olavarría","595",280198,84488,19006,31908,99363,102933,13122,634588,202296,50914
"2012-01-01 00:00:00,000","Chivilcoy","224",36618,12296,2725,6210,13624,13648,1990,87135,27272,8935
"2012-01-01 00:00:00,000","Merlo","539",237,45,10,12,52,65,14,448,117,22
"2012-01-01 00:00:00,000","Magdalena","505",81180,23539,3092,7101,30792,32762,3784,184220,63554,10193
"2012-01-01 00:00:00,000","Mar Chiquita","518",132784,46930,3115,13513,46420,51877,6738,306834,98297,16628
"2012-01-01 00:00:00,000","Pilar","638",1425,572,117,247,277,440,81,3322,717,364
"2012-01-01 00:00:00,000","Pila","630",127021,33246,2007,5264,42324,43573,4886,259570,85897,7271
"2012-01-01 00:00:00,000","Pehuajó","609",88527,28969,21692,17483,37256,36068,4309,233116,73324,39175
"2012-01-01 00:00:00,000","General Rodríguez","364",6955,2873,302,942,1875,2135,372,15714,4010,1244
"2012-01-01 00:00:00,000","General Viamonte","385",47483,11852,1514,5315,16995,18427,2072,105090,35422,6829
"2012-01-01 00:00:00,000","Esteban Echeverría","260",251,54,20,40,89,92,20,569,181,60
"2012-01-01 00:00:00,000","Ensenada","245",242,33,121,146,68,50,7,649,118,267
"2012-01-01 00:00:00,000","Maipú","511",94374,23552,4082,5916,29942,33178,4076,198356,63120,9998
"2012-01-01 00:00:00,000","Coronel de Marina Leonardo Rosales","182",17158,4455,348,1617,4420,5426,767,35197,9846,1965
"2012-01-01 00:00:00,000","Villarino","875",133324,51660,13171,19224,43779,46975,6429,317758,90754,32395
"2012-01-01 00:00:00,000","Dolores","238",77408,22352,2812,5790,24713,26559,3481,164961,51272,8602
"2012-01-01 00:00:00,000","Coronel Suárez","203",114274,42353,17125,15911,53886,51386,6460,298895,105272,33036
"2012-01-01 00:00:00,000","Escobar","252",2700,939,133,190,893,837,136,5772,1730,323
"2012-01-01 00:00:00,000","Chacabuco","210",37197,12508,2186,7636,14761,14442,1464,89875,29203,9822
"2012-01-01 00:00:00,000","José M. Ezeiza","270",1014,384,153,176,212,237,38,2239,449,329
"2012-01-01 00:00:00,000","Adolfo Alsina","007",81254,30784,19297,18887,30677,28833,3519,211407,59510,38184
"2012-01-01 00:00:00,000","Navarro","574",58151,23767,4218,7741,16787,20361,1951,136550,37148,11959
"2012-01-01 00:00:00,000","Zárate","882",8068,4203,2126,1533,2365,3123,1469,23645,5488,3659
"2012-01-01 00:00:00,000","Necochea","581",72037,19713,6875,4330,26987,29347,3946,165595,56334,11205
"2012-01-01 00:00:00,000","Punta Indio","655",72677,16984,736,3116,20350,25237,3217,147204,45587,3852
"2012-01-01 00:00:00,000","Colón","175",12682,5160,2438,1237,5332,4906,693,32022,10238,3675
"2012-01-01 00:00:00,000","Marcos Paz","525",12361,5976,404,5838,4277,3650,373,32252,7927,6242
"2012-01-01 00:00:00,000","General Pueyrredón","357",18311,6942,3541,1184,5720,7035,838,44886,12755,4725
"2012-01-01 00:00:00,000","Moreno","560",194,63,14,15,57,50,8,394,107,29
"2012-01-01 00:00:00,000","9 de Julio","588",103554,35007,7269,10466,36456,41781,4563,244421,78237,17735
"2012-01-01 00:00:00,000","Pergamino","623",42329,13170,3728,3853,17224,18962,2138,103142,36186,7581
"2012-01-01 00:00:00,000","Monte","547",54325,19300,3122,8826,18858,22360,2962,133255,41218,11948
"2012-01-01 00:00:00,000","Pellegrini","616",25027,9922,16892,11381,11069,9244,914,82624,20313,28273
"2010-01-01 00:00:00,000","Bahía Blanca","056",21309,14922,3578,8060,6293,7066,1621,63622,13359,11638
"2010-01-01 00:00:00,000","Tigre","805",177,47,24,4,58,48,13,361,106,28
"2010-01-01 00:00:00,000","General Villegas","392",104960,43336,40640,49853,44516,45925,5639,336278,90441,90493
"2010-01-01 00:00:00,000","General Paz","343",55882,15477,4217,3961,16508,19486,2311,120820,35994,8178
"2010-01-01 00:00:00,000","General Pueyrredón","357",18232,6863,4408,1782,6884,5008,1001,42302,11892,6190
"2010-01-01 00:00:00,000","Tres Lomas","847",21475,9840,7519,11964,8570,10098,746,71740,18668,19483
"2010-01-01 00:00:00,000","Florentino Ameghino","277",40730,12033,6411,4945,17413,19388,1878,104773,36801,11356
"2010-01-01 00:00:00,000","25 de Mayo","854",112904,33469,13393,21767,43508,44663,6442,277301,88171,35160
"2010-01-01 00:00:00,000","Tres Arroyos","833",91503,19554,13902,7864,38757,39393,3959,215568,78150,21766
"2010-01-01 00:00:00,000","Arrecifes","077",14428,3265,2047,4021,5982,6050,845,36706,12032,6068
"2010-01-01 00:00:00,000","Adolfo Gonzales Chaves","014",90489,18906,5350,6628,30134,31242,4731,188588,61376,11978
"2010-01-01 00:00:00,000","Almirante Brown","028",228,43,8,22,38,45,16,407,83,30
"2010-01-01 00:00:00,000","General Viamonte","385",47635,8876,1639,6226,14969,17670,2137,101853,32639,7865
"2010-01-01 00:00:00,000","General Rodríguez","364",7065,2130,859,612,2002,2492,308,15958,4494,1471
"2010-01-01 00:00:00,000","Trenque Lauquen","826",97797,37824,19657,26726,38628,43238,3367,271847,81866,46383
"2010-01-01 00:00:00,000","Villarino","875",112084,41315,16852,22934,29441,30301,6313,260100,59742,39786
"2010-01-01 00:00:00,000","Ayacucho","042",277418,59046,21592,33164,90227,97729,13496,600174,187956,54756
"2010-01-01 00:00:00,000","General Pinto","351",60078,22806,5404,11169,19520,21769,2820,145815,41289,16573
"2010-01-01 00:00:00,000","Tornquist","819",54104,25603,9503,17406,14960,16901,3689,144107,31861,26909
"2010-01-01 00:00:00,000","Guaminí","399",84083,28515,23461,25281,41779,40828,4857,247853,82607,48742
"2010-01-01 00:00:00,000","Alberti","021",15265,3621,2235,3164,5670,5904,2116,38209,11574,5399
"2010-01-01 00:00:00,000","Azul","049",216613,60356,20385,25401,76073,81013,12051,496832,157086,45786
"2010-01-01 00:00:00,000","Capitán Sarmiento","140",362,99,17,43,103,79,23,702,182,60
"2010-01-01 00:00:00,000","Zárate","882",7468,3581,7698,2213,2231,1922,494,25298,4153,9911
"2010-01-01 00:00:00,000","Tordillo","812",49174,13411,4278,5329,15935,16757,2293,107999,32692,9607
"2010-01-01 00:00:00,000","Hipólito Yrigoyen","406",28844,10349,9660,10091,11412,10355,1255,80909,21767,19751
"2010-01-01 00:00:00,000","Navarro","574",56709,23298,6604,7491,18359,19101,2083,134387,37460,14095
"2010-01-01 00:00:00,000","Salto","714",16468,5775,2817,5233,9460,9319,717,49648,18779,8050
"2010-01-01 00:00:00,000","General Juan Madariaga","315",85979,21312,12103,12643,28855,30715,4010,197477,59570,24746
"2010-01-01 00:00:00,000","Pilar","638",2205,955,173,328,489,518,95,4792,1007,501
"2010-01-01 00:00:00,000","Mar Chiquita","518",119925,34303,4453,12579,38009,43067,6423,263817,81076,17032
"2010-01-01 00:00:00,000","Chivilcoy","224",37151,10628,4535,5771,13405,13535,1872,87027,26940,10306
"2010-01-01 00:00:00,000","Malvinas Argentinas","515",590,81,42,70,17,11,24,829,28,112
"2010-01-01 00:00:00,000","Exaltación de la Cruz","266",9242,4988,399,3034,3517,3835,716,26049,7352,3433
"2010-01-01 00:00:00,000","Puán","651",80987,28348,11767,16907,22511,23919,5086,190933,46430,28674
"2010-01-01 00:00:00,000","Chascomús","218",169246,41111,9587,19945,48546,53292,7903,354376,101838,29532
"2010-01-01 00:00:00,000","Maipú","511",90401,15285,5759,6731,29144,26152,4668,175148,55296,12490
"2010-01-01 00:00:00,000","Colón","175",12659,2749,2704,3559,4761,4849,701,32070,9610,6263
"2010-01-01 00:00:00,000","José M. Ezeiza","270",1224,347,170,77,323,376,53,2623,699,247
"2010-01-01 00:00:00,000","Chacabuco","210",36630,11460,3313,8039,14323,14794,1468,90498,29117,11352
"2010-01-01 00:00:00,000","Ramallo","665",11995,4319,2487,4237,4190,4864,591,33357,9054,6724
"2010-01-01 00:00:00,000","Magdalena","505",74414,20643,5505,9242,24872,25071,3606,163552,49943,14747
"2010-01-01 00:00:00,000","Castelli","168",65789,21381,7085,7246,19203,21149,3192,146991,40352,14331
"2010-01-01 00:00:00,000","Florencio Varela","274",2420,822,112,477,639,749,100,5429,1388,589
"2010-01-01 00:00:00,000","Rauch","672",174375,40191,7552,12936,53425,59587,7419,361647,113012,20488
"2010-01-01 00:00:00,000","Patagones","602",76910,35788,23610,19026,21141,20364,4420,200482,41505,42636
"2010-01-01 00:00:00,000","Rivadavia","679",39171,22257,26817,62685,28887,20432,1579,193373,49319,89502
"2010-01-01 00:00:00,000","Punta Indio","655",68495,15984,1492,5583,17390,20903,3217,136577,38293,7075
"2010-01-01 00:00:00,000","Esteban Echeverría","260",169,24,29,2,39,56,8,344,95,31
"2010-01-01 00:00:00,000","Pila","630",124564,29278,5001,15194,40938,40935,5993,261900,81873,20195
"2010-01-01 00:00:00,000","Marcos Paz","525",12573,11523,1006,5682,1725,3786,328,38684,5511,6688
"2010-01-01 00:00:00,000","Daireaux","231",80742,21836,15522,7965,26332,27961,3986,185973,54293,23487
"2010-01-01 00:00:00,000","Moreno","560",159,73,7,24,41,55,7,380,96,31
"2010-01-01 00:00:00,000","Dolores","238",77874,24022,4745,9565,25616,23169,3714,166258,48785,14310
"2010-01-01 00:00:00,000","Necochea","581",68056,14622,9834,4803,22199,23663,4240,148881,45862,14637
"2010-01-01 00:00:00,000","Coronel Suárez","203",107355,31972,17569,12916,42249,42614,6692,261732,84863,30485
"2010-01-01 00:00:00,000","9 de Julio","588",102266,29898,8050,16190,34655,42441,4719,246005,77096,24240
"2010-01-01 00:00:00,000","Monte","547",56421,17097,5912,6211,22669,20708,2817,129874,43377,12123
"2010-01-01 00:00:00,000","Ensenada","245",286,57,239,357,82,58,17,1072,140,596
"2010-01-01 00:00:00,000","Coronel de Marina Leonardo Rosales","182",15997,4432,1297,2128,4082,4281,1058,33474,8363,3425
"2010-01-01 00:00:00,000","Olavarría","595",272204,72134,23408,33458,94100,95932,14049,607117,190032,56866
"2010-01-01 00:00:00,000","Merlo","539",433,162,15,19,88,83,27,822,171,34
"2010-01-01 00:00:00,000","Pehuajó","609",92631,24355,18511,26299,38788,34406,3775,234383,73194,44810
"2010-01-01 00:00:00,000","Coronel Pringles","196",111649,23850,7859,12515,35086,38139,7276,239427,73225,20374
"2010-01-01 00:00:00,000","Escobar","252",3201,1150,269,411,1050,1012,161,7216,2062,680
"2010-01-01 00:00:00,000","Pellegrini","616",21302,12403,17174,15047,11454,8215,1001,83357,19669,32221
"2010-01-01 00:00:00,000","Mercedes","532",28123,13590,3621,6329,11039,10532,1594,74321,21571,9950
"2010-01-01 00:00:00,000","Coronel Dorrego","189",65312,24816,12942,11633,21625,22133,3486,162455,43758,24575
"2010-01-01 00:00:00,000","Pergamino","623",41740,13664,8110,8063,14319,14544,2166,102831,28863,16173
"2010-01-01 00:00:00,000","Brandsen","119",54662,14618,4709,5031,18919,15376,2197,111969,34295,9740
"2010-01-01 00:00:00,000","Luján","497",12455,4404,715,1385,2979,3843,967,27612,6822,2100
"2010-01-01 00:00:00,000","Tapalqué","798",146481,27883,5649,9124,48310,50322,7061,296842,98632,14773
"2010-01-01 00:00:00,000","General Alvarado","280",23013,7771,4105,3239,7599,8170,1397,55865,15769,7344
"2010-01-01 00:00:00,000","Carmen de Areco","161",28224,11343,3436,5230,8082,9940,1007,69120,18022,8666
"2010-01-01 00:00:00,000","San Fernando","749",3814,920,157,408,921,989,182,7459,1910,565
"2010-01-01 00:00:00,000","Laprida","448",114843,31988,11944,14654,36525,39758,6289,259234,76283,26598
"2010-01-01 00:00:00,000","General La Madrid","322",131509,31629,11920,13809,45883,48295,6957,292414,94178,25729
"2010-01-01 00:00:00,000","Berisso","098",870,190,574,226,422,210,35,2315,632,800
"2010-01-01 00:00:00,000","San Nicolás","763",9140,1664,307,1372,2805,2836,349,18504,5641,1679
"2010-01-01 00:00:00,000","Berazategui","091",2405,588,775,804,512,458,73,5561,970,1579
"2010-01-01 00:00:00,000","San Pedro","770",14322,5661,17225,7263,4534,4832,770,54905,9366,24488
"2010-01-01 00:00:00,000","La Plata","441",22298,6402,1616,2054,11804,10473,1021,54337,22277,3670
"2010-01-01 00:00:00,000","Bolívar","105",154197,39905,16233,30062,58347,58301,7445,364444,116648,46295
"2010-01-01 00:00:00,000","General Las Heras","329",40042,13735,3106,7114,15057,12977,1666,91617,28034,10220
"2010-01-01 00:00:00,000","Benito Juárez","084",148952,39003,18030,11567,51149,56786,7719,338843,107935,29597
"2010-01-01 00:00:00,000","La Matanza","427",1091,405,140,160,242,193,59,2241,435,300
"2010-01-01 00:00:00,000","General Lavalle","336",77064,20097,9490,10535,24087,26773,3950,174682,50860,20025
"2010-01-01 00:00:00,000","Suipacha","784",32171,11419,3169,3724,9248,7758,1408,67407,17006,6893
"2010-01-01 00:00:00,000","Baradero","070",15021,5530,6181,3500,4998,5172,743,41319,10170,9681
"2010-01-01 00:00:00,000","Junín","413",37592,8512,2479,4302,13728,12165,2122,79337,25893,6781
"2010-01-01 00:00:00,000","Tandil","791",111758,40548,21942,15064,45197,41962,5565,278801,87159,37006
"2010-01-01 00:00:00,000","Balcarce","063",95215,27948,15807,18234,36680,37341,5789,237675,74021,34041
"2010-01-01 00:00:00,000","San Vicente","778",28740,7269,1591,1872,9291,7971,1485,56899,17262,3463
"2010-01-01 00:00:00,000","San Cayetano","742",44872,9269,2083,6058,17370,16828,2179,98117,34198,8141
"2010-01-01 00:00:00,000","General Guido","308",96535,18156,4035,4921,27421,30387,4482,188903,57808,8956
"2010-01-01 00:00:00,000","Bragado","112",38686,8797,3930,3993,13150,12470,1699,82045,25620,7923
"2010-01-01 00:00:00,000","Lobos","483",50073,17431,3941,8041,17726,16419,2267,114591,34145,11982
"2010-01-01 00:00:00,000","Roque Pérez","693",36987,10460,3719,4465,22273,19635,1849,96750,41908,8184
"2010-01-01 00:00:00,000","General Alvear","287",118985,31760,4611,11718,37306,41915,6118,257022,79221,16329
"2010-01-01 00:00:00,000","Carlos Tejedor","154",87446,29723,20539,22822,33650,29953,3878,224314,63603,43361
"2010-01-01 00:00:00,000","Saavedra","700",60064,17658,9062,9857,20403,21666,3425,143398,42069,18919
"2010-01-01 00:00:00,000","Lobería","476",78274,25049,13099,16176,29754,32254,5391,202497,62008,29275
"2010-01-01 00:00:00,000","Carlos Casares","147",59220,21874,9702,16782,20751,20929,2883,152319,41680,26484
"2010-01-01 00:00:00,000","Saladillo","707",78457,20497,8425,12868,38880,38498,4601,201844,77378,21293
"2010-01-01 00:00:00,000","Capitán Sarmiento","140",6575,2172,367,2111,2005,2848,364,17285,4853,2478
"2010-01-01 00:00:00,000","Lincoln","469",155846,48307,18262,23711,56338,58025,9890,372066,114363,41973
"2010-01-01 00:00:00,000","Salliqueló","721",17199,9743,14528,18151,9362,3302,848,67073,12664,32679
"2010-01-01 00:00:00,000","General Arenales","294",13243,3095,182,1895,3515,4288,641,27632,7803,2077
"2010-01-01 00:00:00,000","Cañuelas","134",51527,13871,1796,4507,18635,15365,2517,104948,34000,6303
"2010-01-01 00:00:00,000","General Belgrano","301",55088,19718,6098,10248,19581,20164,3368,134848,39745,16346
"2010-01-01 00:00:00,000","Leandro N. Alem","462",30588,10735,3366,6428,8640,9030,1397,70574,17670,9794
"2010-01-01 00:00:00,000","San Andrés de Giles","728",21313,7821,5280,7130,5915,6709,953,55915,12624,12410
"2010-01-01 00:00:00,000","Campana","126",5593,1134,1436,975,2005,1928,207,13201,3933,2411
"2010-01-01 00:00:00,000","San Antonio de Areco","735",12094,5125,3482,4909,5119,4741,840,35932,9860,8391
"2010-01-01 00:00:00,000","Las Flores","455",142692,30185,2856,5172,50715,46392,6322,280011,97107,8028
"2010-01-01 00:00:00,000","Rojas","686",25870,8315,6902,5406,11746,11541,1382,70957,23287,12308
"2010-01-01 00:00:00,000","Adolfo Alsina","007",73728,23288,24469,24146,26042,25452,3517,200052,51494,48615
"2016-01-01 00:00:00,000","San Antonio de Areco","735",10497,2945,997,1551,5962,4790,646,26216,10752,2548
"2016-01-01 00:00:00,000","San Vicente","778",29365,6408,603,1601,8014,9764,1424,58929,17778,2204
"2016-01-01 00:00:00,000","Laprida","448",147810,40417,12914,16836,51085,57302,6101,338682,108387,29750
"2016-01-01 00:00:00,000","Bolívar","105",169064,49674,8997,20768,59296,62877,8245,382502,122173,29765
"2016-01-01 00:00:00,000","Baradero","070",14731,4507,2541,3134,7485,6334,665,38246,13819,5675
"2016-01-01 00:00:00,000","Lincoln","469",174734,48428,12773,21011,62743,67976,6520,399418,130719,33784
"2016-01-01 00:00:00,000","General Belgrano","301",58643,19951,3276,5541,22740,24634,2802,139481,47374,8817
"2016-01-01 00:00:00,000","San Cayetano","742",49900,12604,810,8517,19027,20644,2005,115124,39671,9327
"2016-01-01 00:00:00,000","Las Flores","455",141476,29661,2541,4994,43230,51271,6542,287756,94501,7535
"2016-01-01 00:00:00,000","Benito Juárez","084",199235,41613,9720,9725,64309,73524,8306,415647,137833,19445
"2016-01-01 00:00:00,000","General Alvear","287",136402,44167,4871,11900,44665,50530,5703,304103,95195,16771
"2016-01-01 00:00:00,000","San Nicolás","763",9216,1767,31,822,3077,3030,360,18256,6107,853
"2016-01-01 00:00:00,000","General Arenales","294",14761,2960,109,1338,5606,6148,666,32130,11754,1447
"2016-01-01 00:00:00,000","Berisso","098",1914,247,867,224,401,383,53,4071,784,1091
"2016-01-01 00:00:00,000","San Fernando","749",4099,788,250,138,835,1172,162,7781,2007,388
"2016-01-01 00:00:00,000","Berazategui","091",1662,384,1124,323,534,423,80,4419,957,1447
"2016-01-01 00:00:00,000","San Pedro","770",15510,4817,4136,7463,9139,6016,779,44737,15155,11599
"2016-01-01 00:00:00,000","Leandro N. Alem","462",29255,10728,2703,4701,10503,10594,1352,69927,21097,7404
"2016-01-01 00:00:00,000","Pellegrini","616",25154,11472,10079,8575,14893,12669,1080,81698,27562,18654
"2016-01-01 00:00:00,000","Suipacha","784",35903,10521,1585,3036,10468,12530,1547,77652,22998,4621
"2016-01-01 00:00:00,000","Guaminí","399",101155,35129,13845,18033,41084,44855,4247,262119,85939,31878
"2016-01-01 00:00:00,000","Florentino Ameghino","277",51697,16234,4250,6504,21763,20867,2112,122531,42630,10754
"2016-01-01 00:00:00,000","Tres Arroyos","833",92659,26450,7036,10325,36116,39803,3826,219902,75919,17361
"2016-01-01 00:00:00,000","Adolfo Gonzales Chaves","014",96606,28302,2634,6548,32246,35609,4615,209923,67855,9182
"2016-01-01 00:00:00,000","General Paz","343",60535,19190,1972,3657,19499,23396,2332,134478,42895,5629
"2016-01-01 00:00:00,000","Almirante Brown","028",136,32,1,5,46,52,10,288,98,6
"2016-01-01 00:00:00,000","Tres Lomas","847",21461,10288,6918,7319,9875,8290,800,63366,18165,14237
"2016-01-01 00:00:00,000","Trenque Lauquen","826",116426,47522,16617,36994,39820,45856,3649,312920,85676,53611
"2016-01-01 00:00:00,000","General Villegas","392",123740,53999,35134,32783,54202,53562,4983,357763,107764,67917
"2016-01-01 00:00:00,000","25 de Mayo","854",119926,37703,4278,14334,55295,54594,5536,290965,109889,18612
"2016-01-01 00:00:00,000","Alberti","021",16230,3193,873,2103,6964,6736,864,36735,13700,2976
"2016-01-01 00:00:00,000","Villarino","875",166956,57446,17934,21858,55367,58373,7579,388519,113740,39792
"2016-01-01 00:00:00,000","General Viamonte","385",47738,11144,1738,5695,19772,20099,1851,108364,39871,7433
"2016-01-01 00:00:00,000","General Pueyrredón","357",16829,7219,4070,2745,6030,7106,804,45879,13136,6815
"2016-01-01 00:00:00,000","Adolfo Alsina","007",103097,34050,20949,19312,39012,37928,3495,256759,76940,40261
"2016-01-01 00:00:00,000","Zárate","882",8612,3469,1722,1817,4165,3942,749,24253,8107,3539
"2016-01-01 00:00:00,000","General Pinto","351",67693,20137,3363,6573,24497,28476,2722,157440,52973,9936
"2016-01-01 00:00:00,000","General Guido","308",111133,17679,1790,3129,32657,38303,4233,214570,70960,4919
"2016-01-01 00:00:00,000","General Juan Madariaga","315",112843,26532,9474,15778,39500,41113,4612,251465,80613,25252
"2016-01-01 00:00:00,000","Hipólito Yrigoyen","406",26947,10927,9503,8477,14456,11838,1123,80653,26294,17980
"2016-01-01 00:00:00,000","Balcarce","063",110050,36313,12246,11499,43919,44610,5440,264768,88529,23745
"2016-01-01 00:00:00,000","La Plata","441",22040,7061,1012,2906,9840,11122,1072,56335,20962,3918
"2016-01-01 00:00:00,000","Tandil","791",125547,49249,17500,15094,44994,50166,5088,312810,95160,32594
"2016-01-01 00:00:00,000","General La Madrid","322",173408,53058,13875,17540,62466,66075,6642,396673,128541,31415
"2016-01-01 00:00:00,000","Bahía Blanca","056",39807,18685,2345,7363,14004,14278,1954,98710,28282,9708
"2016-01-01 00:00:00,000","La Matanza","427",805,304,16,115,173,236,29,1741,409,131
"2016-01-01 00:00:00,000","Tapalqué","798",170281,38429,2734,7164,49696,57487,7270,340852,107183,9898
"2016-01-01 00:00:00,000","Arrecifes","077",16591,5552,2128,4296,9199,10302,849,50020,19501,6424
"2016-01-01 00:00:00,000","General Las Heras","329",36551,12208,2108,3028,13025,14413,1454,84175,27438,5136
"2016-01-01 00:00:00,000","Tigre","805",154,35,14,7,19,30,7,277,49,21
"2016-01-01 00:00:00,000","Junín","413",34654,7251,1160,2095,15367,15883,1591,78517,31250,3255
"2016-01-01 00:00:00,000","José C. Paz","412",192,71,8,31,106,64,5,435,170,39
"2016-01-01 00:00:00,000","Tordillo","812",53900,14424,3192,5840,17759,21140,2280,121916,38899,9032
"2016-01-01 00:00:00,000","General Lavalle","336",84519,18594,7027,5579,26143,30330,4336,180715,56473,12606
"2016-01-01 00:00:00,000","Ayacucho","042",334688,77842,13944,29298,111458,120283,13369,709707,231741,43242
"2016-01-01 00:00:00,000","Tornquist","819",89394,34342,8939,14718,29187,31133,3797,213456,60320,23657
"2016-01-01 00:00:00,000","Azul","049",227969,69562,10526,23252,83301,89881,10291,521362,173182,33778
"2016-01-01 00:00:00,000","General Alvarado","280",24129,8384,1575,6611,9471,8894,981,59468,18365,8186
"2016-01-01 00:00:00,000","Lobería","476",87277,26518,7639,8759,33014,34775,4061,203804,67789,16398
"2016-01-01 00:00:00,000","General Rodríguez","364",7583,1847,454,497,1891,2564,282,15791,4455,951
"2016-01-01 00:00:00,000","Carlos Casares","147",67483,21114,6652,12804,24102,25551,2647,161802,49653,19456
"2016-01-01 00:00:00,000","9 de Julio","588",111540,33975,3808,9247,44200,48250,4228,259298,92450,13055
"2016-01-01 00:00:00,000","Mar Chiquita","518",135883,41854,3184,12279,45997,51431,7336,303398,97428,15463
"2016-01-01 00:00:00,000","Roque Pérez","693",48714,10007,1329,4724,21321,21644,2273,110335,42965,6053
"2016-01-01 00:00:00,000","Rojas","686",25359,7783,4693,5027,9816,10416,1093,64787,20232,9720
"2016-01-01 00:00:00,000","Carlos Tejedor","154",101935,34705,12450,15696,37371,41138,4271,251333,78509,28146
"2016-01-01 00:00:00,000","Escobar","252",2803,836,87,87,755,954,185,5906,1709,174
"2016-01-01 00:00:00,000","Marcos Paz","525",11230,4616,1029,3349,5564,4509,352,29594,10073,4378
"2016-01-01 00:00:00,000","Coronel de Marina Leonardo Rosales","182",18091,5191,885,2014,4515,5678,826,38363,10193,2899
"2016-01-01 00:00:00,000","Pilar","638",1454,547,54,77,480,569,75,3345,1049,131
"2016-01-01 00:00:00,000","Chascomús","218",179159,57585,5354,19686,58540,66017,7138,400956,124557,25040
"2016-01-01 00:00:00,000","Rivadavia","679",54937,26011,22939,47267,33840,20062,1984,193262,53902,70206
"2016-01-01 00:00:00,000","Carmen de Areco","161",30014,13778,2208,1690,11155,13361,1260,75672,24516,3898
"2016-01-01 00:00:00,000","Necochea","581",77432,17597,5061,4698,25471,30195,3741,168919,55666,9759
"2016-01-01 00:00:00,000","Ensenada","245",206,58,343,86,54,48,10,799,102,429
"2016-01-01 00:00:00,000","Mercedes","532",35432,11652,2212,2452,12031,12810,1521,78889,24841,4664
"2016-01-01 00:00:00,000","Rauch","672",194997,46484,6839,9964,59283,68633,8298,403848,127916,16803
"2016-01-01 00:00:00,000","Merlo","539",297,58,3,16,40,52,13,491,92,19
"2016-01-01 00:00:00,000","Patagones","602",122485,36751,15066,18993,43922,45794,5419,290302,89716,34059
"2016-01-01 00:00:00,000","Dolores","238",77500,21203,3978,4585,24035,26152,3559,163129,50187,8563
"2016-01-01 00:00:00,000","Coronel Suárez","203",135022,41457,16724,16199,55002,56263,6437,328365,111265,32923
"2016-01-01 00:00:00,000","Puán","651",128638,40265,13601,20317,44763,46252,6399,301724,91015,33918
"2016-01-01 00:00:00,000","Chacabuco","210",37587,9995,1617,5914,16192,15524,1416,87577,31716,7531
"2016-01-01 00:00:00,000","Monte","547",55084,18711,4604,6023,19487,21595,2216,129828,41082,10627
"2016-01-01 00:00:00,000","Ramallo","665",12981,5334,1517,5465,8105,7114,526,40051,15219,6982
"2016-01-01 00:00:00,000","Navarro","574",57305,23052,3604,6338,18610,20570,1761,133200,39180,9942
"2016-01-01 00:00:00,000","Castelli","168",74574,19302,3768,4525,21153,25063,3010,155305,46216,8293
"2016-01-01 00:00:00,000","Punta Indio","655",78358,17026,795,2166,22101,26510,3767,155132,48611,2961
"2016-01-01 00:00:00,000","Daireaux","231",93130,23134,6452,9533,30762,33873,3859,203854,64635,15985
"2016-01-01 00:00:00,000","Chivilcoy","224",36195,11224,1768,6366,13537,13069,1818,83509,26606,8134
"2016-01-01 00:00:00,000","Saavedra","700",80604,27729,5616,10561,26842,30958,3883,190309,57800,16177
"2016-01-01 00:00:00,000","Moreno","560",84,22,2,7,55,42,9,208,97,9
"2016-01-01 00:00:00,000","Pila","630",129445,31570,2763,5833,40917,47388,5154,269541,88305,8596
"2016-01-01 00:00:00,000","San Andrés de Giles","728",22541,7307,4534,5404,8802,9432,1067,59717,18234,9938
"2016-01-01 00:00:00,000","Pehuajó","609",96057,28389,17789,11409,38943,36310,3707,229971,75253,29198
"2016-01-01 00:00:00,000","Lobos","483",54835,22129,2412,5848,24027,24967,2014,137172,48994,8260
"2016-01-01 00:00:00,000","Coronel Dorrego","189",81693,27513,10532,11354,28518,29526,3062,193206,58044,21886
"2016-01-01 00:00:00,000","Bragado","112",37845,8486,1956,3117,14942,15329,1513,83575,30271,5073
"2016-01-01 00:00:00,000","Florencio Varela","274",2718,545,63,272,881,836,106,5376,1717,335
"2016-01-01 00:00:00,000","Brandsen","119",62738,14439,1031,1735,18660,22276,3036,127531,40936,2766
"2016-01-01 00:00:00,000","Salto","714",15261,3107,787,1887,9541,8559,637,38797,18100,2674
"2016-01-01 00:00:00,000","Campana","126",8790,1366,451,736,2756,2298,399,16338,5054,1187
"2016-01-01 00:00:00,000","Pergamino","623",46836,13807,4035,3449,17720,19409,2090,109035,37129,7484
"2016-01-01 00:00:00,000","Luján","497",13833,4979,381,1045,4384,5153,605,31149,9537,1426
"2016-01-01 00:00:00,000","Maipú","511",105727,21964,4695,7090,30094,35470,4688,215104,65564,11785
"2016-01-01 00:00:00,000","José M. Ezeiza","270",638,156,121,71,172,204,30,1424,376,192
"2016-01-01 00:00:00,000","Cañuelas","134",55293,12779,1192,2917,16409,19923,2254,114281,36332,4109
"2016-01-01 00:00:00,000","Olavarría","595",289550,71899,13798,27898,103602,101055,12955,618210,204657,41696
"2016-01-01 00:00:00,000","Salliqueló","721",18087,8779,10815,7453,9219,6034,939,58141,15253,18268
"2016-01-01 00:00:00,000","Magdalena","505",94362,20577,3804,7211,30369,33457,4006,196874,63826,11015
"2016-01-01 00:00:00,000","Saladillo","707",84428,31150,4772,16678,35930,36769,4609,215175,72699,21450
"2016-01-01 00:00:00,000","Capitán Sarmiento","140",5875,2243,139,788,2482,2792,381,15010,5274,927
"2016-01-01 00:00:00,000","Colón","175",15631,3755,1105,1419,5333,5532,686,33660,10865,2524
"2016-01-01 00:00:00,000","Exaltación de la Cruz","266",9885,2221,306,801,2608,2839,551,19442,5447,1107
"2016-01-01 00:00:00,000","Coronel Pringles","196",147482,35890,5843,14188,50098,54437,6570,318847,104535,20031
"2019-01-01 00:00:00,000","Zárate","882",9058,2613,1485,1122,3095,3448,518,21692,6543,2607
"2019-01-01 00:00:00,000","San Andrés de Giles","728",23340,9196,2015,6081,10858,11194,960,63980,22052,8096
"2019-01-01 00:00:00,000","Lobería","476",97025,30057,9575,13014,39629,42473,3971,238588,82102,22589
"2019-01-01 00:00:00,000","Florencio Varela","274",2731,700,43,100,780,728,126,5156,1508,143
"2019-01-01 00:00:00,000","Bragado","112",42675,8844,1937,4325,15349,15405,1587,90178,30754,6262
"2019-01-01 00:00:00,000","Salto","714",17307,4330,744,2763,10370,9793,634,45364,20163,3507
"2019-01-01 00:00:00,000","Lobos","483",59147,24791,2236,8458,24379,26559,2030,149780,50938,10694
"2019-01-01 00:00:00,000","José M. Ezeiza","270",785,152,37,50,281,330,36,1720,611,87
"2019-01-01 00:00:00,000","Bolívar","105",175744,52360,8132,25118,65486,69096,8359,407905,134582,33250
"2019-01-01 00:00:00,000","Campana","126",8833,1391,541,1216,2387,2409,374,17173,4796,1757
"2019-01-01 00:00:00,000","Saladillo","707",94718,37775,5478,19101,42841,41537,4514,244660,84378,24579
"2019-01-01 00:00:00,000","Luján","497",14363,6039,558,2069,4507,6227,527,36010,10734,2627
"2019-01-01 00:00:00,000","Cañuelas","134",55814,13721,782,3039,16632,21250,2569,118425,37882,3821
"2019-01-01 00:00:00,000","Exaltación de la Cruz","266",9882,2704,233,1356,5582,5114,435,24838,10696,1589
"2019-01-01 00:00:00,000","Saavedra","700",84915,23427,5512,11674,29123,31955,3645,193083,61078,17186
"2019-01-01 00:00:00,000","Capitán Sarmiento","140",6195,2028,246,518,3579,3203,339,15732,6782,764
"2019-01-01 00:00:00,000","Magdalena","505",95946,16763,2863,6937,32897,35040,4355,196944,67937,9800
"2019-01-01 00:00:00,000","Salliqueló","721",21128,10642,9915,10067,9208,8552,1018,69874,17760,19982
"2019-01-01 00:00:00,000","General Alvarado","280",26326,8788,856,7012,9824,10270,1198,64720,20094,7868
"2019-01-01 00:00:00,000","Lincoln","469",188406,56400,10213,27561,72849,76381,8276,443618,149230,37774
"2019-01-01 00:00:00,000","San Antonio de Areco","735",12471,2841,1006,3300,6060,5705,617,31645,11765,4306
"2019-01-01 00:00:00,000","San Vicente","778",28861,6126,711,1188,8215,9747,1117,57497,17962,1899
"2019-01-01 00:00:00,000","La Plata","441",22573,5796,611,2225,11336,11432,960,55029,22768,2836
"2019-01-01 00:00:00,000","Laprida","448",152859,33857,11293,12669,45402,50658,6252,318246,96060,23962
"2019-01-01 00:00:00,000","Baradero","070",15798,6205,1900,4469,7581,7217,719,43525,14798,6369
"2019-01-01 00:00:00,000","General Belgrano","301",65802,18626,4270,5304,22086,24401,2815,145619,46487,9574
"2019-01-01 00:00:00,000","San Pedro","770",16496,5532,1346,6062,11060,8621,780,47458,19681,7408
"2019-01-01 00:00:00,000","Las Flores","455",146355,31300,3227,8020,46183,49368,6590,294228,95551,11247
"2019-01-01 00:00:00,000","Benito Juárez","084",212835,36942,8788,13060,70806,79257,8686,438825,150063,21848
"2019-01-01 00:00:00,000","San Nicolás","763",9032,1628,96,1412,3076,3080,338,18666,6156,1508
"2019-01-01 00:00:00,000","General Arenales","294",14164,2705,243,1562,6730,6124,612,31534,12854,1805
"2019-01-01 00:00:00,000","San Fernando","749",4503,587,72,207,887,1137,160,7803,2024,279
"2019-01-01 00:00:00,000","Berazategui","091",614,183,312,481,212,180,36,1986,392,793
"2019-01-01 00:00:00,000","Leandro N. Alem","462",30797,9566,1001,5711,11081,11741,1320,71877,22822,6712
"2019-01-01 00:00:00,000","Lezama","466",1417,258,10,14,402,544,46,2833,946,24
"2019-01-01 00:00:00,000","San Cayetano","742",59343,11927,1018,12664,22188,23415,2380,134162,45603,13682
"2019-01-01 00:00:00,000","General Alvear","287",146287,42576,5697,13864,46420,50827,5740,315818,97247,19561
"2019-01-01 00:00:00,000","Berisso","098",1512,276,728,625,457,389,60,3979,846,1353
"2019-01-01 00:00:00,000","Roque Pérez","693",51508,11699,661,3564,24054,25424,2285,120565,49478,4225
"2019-01-01 00:00:00,000","Balcarce","063",118822,41267,15210,16223,49297,49536,5801,296395,98833,31433
"2019-01-01 00:00:00,000","Esteban Echeverría","260",262,63,16,53,24,33,10,470,57,69
"2019-01-01 00:00:00,000","Carlos Casares","147",75811,24816,5005,14980,27708,31222,2840,185896,58930,19985
"2019-01-01 00:00:00,000","Presidente Perón","648",1276,537,107,318,458,443,50,3174,901,425
"2019-01-01 00:00:00,000","Navarro","574",61230,23328,3237,5615,23221,25685,1977,146757,48906,8852
"2019-01-01 00:00:00,000","Coronel de Marina Leonardo Rosales","182",22267,5505,1198,2959,5615,6531,854,45845,12146,4157
"2019-01-01 00:00:00,000","Chascomús","218",176855,56218,3755,18848,57456,65407,7127,393617,122863,22603
"2019-01-01 00:00:00,000","Pilar","638",1350,498,102,139,371,419,59,2986,790,241
"2019-01-01 00:00:00,000","Necochea","581",85794,19046,4337,7729,29025,34483,3567,189439,63508,12066
"2019-01-01 00:00:00,000","Pila","630",136871,30438,1622,6886,36883,43453,4894,267617,80336,8508
"2019-01-01 00:00:00,000","Chacabuco","210",39504,10414,1618,6141,16947,17116,1410,93319,34063,7759
"2019-01-01 00:00:00,000","Chivilcoy","224",36433,12066,2300,5366,14544,14640,1551,86996,29184,7666
"2019-01-01 00:00:00,000","Coronel Pringles","196",155431,28776,5176,11581,43719,49989,6812,307754,93708,16757
"2019-01-01 00:00:00,000","Pergamino","623",51071,13040,3080,8189,20448,20378,2009,118145,40826,11269
"2019-01-01 00:00:00,000","Colón","175",17268,3625,928,1577,6221,6606,698,37308,12827,2505
"2019-01-01 00:00:00,000","Olavarría","595",306252,69983,17023,32008,105140,112348,12482,662444,217488,49031
"2019-01-01 00:00:00,000","Coronel Dorrego","189",91256,28213,14222,16779,30917,34095,3460,222120,65012,31001
"2019-01-01 00:00:00,000","Pellegrini","616",31045,9755,10389,11836,17393,12673,1199,89570,30066,22225
"2019-01-01 00:00:00,000","Brandsen","119",65948,14269,1032,1752,20668,24304,2798,134407,44972,2784
"2019-01-01 00:00:00,000","9 de Julio","588",124618,36484,3994,14542,49173,58286,4538,300748,107459,18536
"2019-01-01 00:00:00,000","Coronel Suárez","203",141783,40192,17198,24473,64394,65237,6695,360815,129631,41671
"2019-01-01 00:00:00,000","Puán","651",142646,38771,13285,22111,45003,47624,5892,317953,92627,35396
"2019-01-01 00:00:00,000","Moreno","560",95,22,7,2,27,32,7,197,59,9
"2019-01-01 00:00:00,000","Mar Chiquita","518",143315,43087,7330,13667,52167,56603,7017,327622,108770,20997
"2019-01-01 00:00:00,000","Rojas","686",25381,7305,5204,3755,13335,9256,971,61128,22591,8959
"2019-01-01 00:00:00,000","Escobar","252",3019,890,149,136,561,718,244,5874,1279,285
"2019-01-01 00:00:00,000","Carlos Tejedor","154",116537,36725,12504,17245,47891,45355,4583,278304,93246,29749
"2019-01-01 00:00:00,000","Rivadavia","679",58447,34384,19060,45380,48940,32881,2119,225152,81821,64440
"2019-01-01 00:00:00,000","Marcos Paz","525",11472,3610,850,5045,5577,4711,318,30717,10288,5895
"2019-01-01 00:00:00,000","Ensenada","245",299,50,81,61,102,70,14,645,172,142
"2019-01-01 00:00:00,000","Carmen de Areco","161",31658,14840,1535,3677,11666,14867,1295,82739,26533,5212
"2019-01-01 00:00:00,000","Rauch","672",191323,39285,4995,14377,61366,66530,7694,390734,127896,19372
"2019-01-01 00:00:00,000","Mercedes","532",39145,12211,1706,4097,13635,14991,1562,88703,28626,5803
"2019-01-01 00:00:00,000","Dolores","238",77299,20109,2490,6224,23236,25028,3270,159448,48264,8714
"2019-01-01 00:00:00,000","Ramallo","665",13209,4953,1603,4949,9679,8442,577,42175,18121,6552
"2019-01-01 00:00:00,000","Patagones","602",149326,34874,20366,24676,47233,54432,6556,344662,101665,45042
"2019-01-01 00:00:00,000","Punta Indio","655",81701,17249,911,2719,23910,29117,3270,164084,53027,3630
"2019-01-01 00:00:00,000","Monte","547",56226,20257,3468,6920,21017,24027,2192,137117,45044,10388
"2019-01-01 00:00:00,000","Daireaux","231",99588,24323,5456,13724,33286,35944,3887,218866,69230,19180
"2019-01-01 00:00:00,000","Castelli","168",81263,21846,2462,7169,23312,26297,2773,168107,49609,9631
"2019-01-01 00:00:00,000","Maipú","511",103082,20432,4633,5969,31599,34831,4561,208339,66430,10602
"2019-01-01 00:00:00,000","General Guido","308",111632,18458,3121,6341,31806,37533,4350,218968,69339,9462
"2019-01-01 00:00:00,000","Pehuajó","609",108107,31851,16795,22782,50518,44454,4099,272542,94972,39577
"2019-01-01 00:00:00,000","Tres Lomas","847",21620,10072,6162,9207,10628,9320,722,66423,19948,15369
"2019-01-01 00:00:00,000","Tandil","791",133844,46632,12782,20816,53738,57864,5084,334886,111602,33598
"2019-01-01 00:00:00,000","General Lavalle","336",91608,17812,5662,7345,25918,31557,3814,189355,57475,13007
"2019-01-01 00:00:00,000","Hipólito Yrigoyen","406",30359,11507,11378,12769,15004,14514,992,96033,29518,24147
"2019-01-01 00:00:00,000","25 de Mayo","854",135059,35517,6211,17689,62192,63787,5562,327612,125979,23900
"2019-01-01 00:00:00,000","Tordillo","812",51777,16612,2798,10047,19486,23478,2421,130611,42964,12845
"2019-01-01 00:00:00,000","Adolfo Gonzales Chaves","014",109751,26766,4731,5911,36411,39095,5248,230597,75506,10642
"2019-01-01 00:00:00,000","General Viamonte","385",54057,12765,2248,6789,22607,23587,2201,125234,46194,9037
"2019-01-01 00:00:00,000","General Juan Madariaga","315",106285,26549,8261,19012,36547,38419,4255,241200,74966,27273
"2019-01-01 00:00:00,000","General Pinto","351",68009,23424,3404,6790,25416,28320,2448,160715,53736,10194
"2019-01-01 00:00:00,000","Tres Arroyos","833",103955,29091,10211,10219,43212,44665,3849,246655,87877,20430
"2019-01-01 00:00:00,000","Alberti","021",16601,4510,1734,2776,6956,7279,890,41069,14235,4510
"2019-01-01 00:00:00,000","Tapalqué","798",172917,31158,2146,7137,50706,57482,7003,335325,108188,9283
"2019-01-01 00:00:00,000","Guaminí","399",113350,34126,15470,22181,52396,45227,4309,279890,97623,37651
"2019-01-01 00:00:00,000","Ayacucho","042",346749,81145,15962,40089,119739,126158,13381,749642,245897,56051
"2019-01-01 00:00:00,000","General Las Heras","329",36848,12949,1473,2518,11966,15115,1517,85535,27081,3991
"2019-01-01 00:00:00,000","General Paz","343",58944,17960,1317,3817,20889,22907,2377,130229,43796,5134
"2019-01-01 00:00:00,000","Azul","049",239382,66709,10559,28118,85214,93245,9806,541064,178459,38677
"2019-01-01 00:00:00,000","Adolfo Alsina","007",112900,37044,18952,25647,42904,41960,3953,282416,84864,44599
"2019-01-01 00:00:00,000","Junín","413",35691,9138,1009,3677,13553,14578,2030,80701,28131,4686
"2019-01-01 00:00:00,000","General Villegas","392",118141,56020,34111,30262,57176,55195,5141,354065,112371,64373
"2019-01-01 00:00:00,000","Florentino Ameghino","277",55118,15664,4516,9091,22694,20528,1875,127320,43222,13607
"2019-01-01 00:00:00,000","Villarino","875",200872,55120,20158,28468,60083,62892,8529,438931,122975,48626
"2019-01-01 00:00:00,000","Suipacha","784",38800,10942,1440,3168,10409,11617,1458,79042,22026,4608
"2019-01-01 00:00:00,000","Bahía Blanca","056",45061,15989,2109,6871,13682,14307,2200,100844,27989,8980
"2019-01-01 00:00:00,000","Arrecifes","077",18543,4235,2005,3602,10592,12012,1001,53410,22604,5607
"2019-01-01 00:00:00,000","General Rodríguez","364",8418,2318,368,436,2700,2853,307,17553,5553,804
"2019-01-01 00:00:00,000","Tornquist","819",96211,33988,7132,15266,29801,31637,3895,219766,61438,22398
"2019-01-01 00:00:00,000","Trenque Lauquen","826",128757,62403,28772,41904,54379,64267,3536,393906,118646,70676
"2019-01-01 00:00:00,000","General La Madrid","322",191923,50855,13715,16700,65999,71301,7335,423130,137300,30415
"2019-01-01 00:00:00,000","La Matanza","427",662,222,26,48,220,249,32,1488,469,74
"2019-01-01 00:00:00,000","General Pueyrredón","357",19521,6782,4562,3628,7383,8987,941,53408,16370,8190
"2018-01-01 00:00:00,000","General Paz","343",61611,19517,1449,3333,18514,22272,2374,132828,40786,4782
"2018-01-01 00:00:00,000","Almirante Brown","028",198,24,3,2,80,64,8,363,144,5
"2018-01-01 00:00:00,000","Capitán Sarmiento","140",6137,1660,86,401,2614,3080,392,14836,5694,487
"2018-01-01 00:00:00,000","Mercedes","532",37344,12016,1635,2762,12296,13659,1510,82585,25955,4397
"2018-01-01 00:00:00,000","Rauch","672",189755,37760,3492,12287,57344,62016,7685,375011,119360,15779
"2018-01-01 00:00:00,000","Magdalena","505",96530,18608,3324,5512,35212,36790,3963,201517,72002,8836
"2018-01-01 00:00:00,000","Dolores","238",78480,22068,2343,7087,24860,26081,3430,165570,50941,9430
"2018-01-01 00:00:00,000","Rivadavia","679",59375,36486,26132,46060,40181,30551,2178,231333,70732,72192
"2018-01-01 00:00:00,000","Carmen de Areco","161",32071,14287,1248,1933,12374,14027,1326,78919,26401,3181
"2018-01-01 00:00:00,000","Ensenada","245",265,45,128,135,92,81,11,746,173,263
"2018-01-01 00:00:00,000","Adolfo Gonzales Chaves","014",107811,24778,4285,5738,33481,38147,5205,224111,71628,10023
"2018-01-01 00:00:00,000","Roque Pérez","693",50086,10628,1160,4253,24634,23398,2183,115106,48032,5413
"2018-01-01 00:00:00,000","Marcos Paz","525",12195,5558,1798,4350,5098,4464,348,33177,9562,6148
"2018-01-01 00:00:00,000","Carlos Tejedor","154",113894,37630,12884,18772,42888,44398,4701,276677,87286,31656
"2018-01-01 00:00:00,000","General Juan Madariaga","315",110405,28770,13657,17439,38706,40623,4492,256009,79329,31096
"2018-01-01 00:00:00,000","Trenque Lauquen","826",126684,63644,27437,34463,51768,56429,3242,368328,108197,61900
"2018-01-01 00:00:00,000","Carlos Casares","147",77022,26527,5352,14086,26340,30833,2785,187438,57173,19438
"2018-01-01 00:00:00,000","Escobar","252",2604,768,192,117,681,897,213,5688,1578,309
"2018-01-01 00:00:00,000","Mar Chiquita","518",142001,42045,3782,12442,50027,55596,7180,318642,105623,16224
"2018-01-01 00:00:00,000","Rojas","686",25991,7435,2610,7069,12644,10485,1009,65084,23129,9679
"2018-01-01 00:00:00,000","Tres Arroyos","833",100947,29113,11677,9159,42243,43597,3980,242070,85840,20836
"2018-01-01 00:00:00,000","Florentino Ameghino","277",52441,13540,3481,8590,20752,19326,1958,118662,40078,12071
"2018-01-01 00:00:00,000","Suipacha","784",38989,10765,1685,2690,10558,12108,1454,79799,22666,4375
"2018-01-01 00:00:00,000","Ramallo","665",12565,4284,2136,4077,7249,6490,511,36553,13739,6213
"2018-01-01 00:00:00,000","9 de Julio","588",125812,38652,3464,12771,49989,54065,4454,293283,104054,16235
"2018-01-01 00:00:00,000","Chivilcoy","224",36270,13574,1873,5443,14459,14625,1819,88229,29084,7316
"2018-01-01 00:00:00,000","Pila","630",133003,32337,1059,5775,37140,41997,5128,261296,79137,6834
"2018-01-01 00:00:00,000","Adolfo Alsina","007",116665,35156,21716,22995,41643,41417,4001,283367,83060,44711
"2018-01-01 00:00:00,000","Coronel Pringles","196",156419,34342,4918,11031,46133,53509,6888,320616,99642,15949
"2018-01-01 00:00:00,000","General Pueyrredón","357",20948,7512,4738,3655,7191,8601,893,54948,15792,8393
"2018-01-01 00:00:00,000","Coronel de Marina Leonardo Rosales","182",21531,4920,1094,1523,4624,5498,937,41001,10122,2617
"2018-01-01 00:00:00,000","Pergamino","623",49417,13827,2330,5839,19351,21311,2021,116056,40662,8169
"2018-01-01 00:00:00,000","Villarino","875",194311,58108,20846,25178,61111,63722,8519,434406,124833,46024
"2018-01-01 00:00:00,000","Olavarría","595",300953,72809,24005,22687,100110,106601,12916,646572,206711,46692
"2018-01-01 00:00:00,000","Pellegrini","616",30369,10826,8500,15013,17808,12438,1178,90762,30246,23513
"2018-01-01 00:00:00,000","Coronel Dorrego","189",89693,27868,12269,13277,29704,30332,3337,207108,60036,25546
"2018-01-01 00:00:00,000","Brandsen","119",66283,14306,993,1376,20613,23412,2919,132701,44025,2369
"2018-01-01 00:00:00,000","General Rodríguez","364",7642,2496,519,407,2075,2833,306,17036,4908,926
"2018-01-01 00:00:00,000","Colón","175",16523,3393,815,1205,6129,6500,685,35621,12629,2020
"2018-01-01 00:00:00,000","Pilar","638",1477,411,102,59,508,560,86,3255,1068,161
"2018-01-01 00:00:00,000","General Viamonte","385",54693,13123,1952,5748,21927,22541,2150,122748,44468,7700
"2018-01-01 00:00:00,000","Chascomús","218",177327,58526,5396,20726,55513,63170,7122,395437,118683,26122
"2018-01-01 00:00:00,000","Monte","547",58887,20528,2906,8218,19358,23189,2350,139267,42547,11124
"2018-01-01 00:00:00,000","General Villegas","392",114485,44615,26875,27488,61262,58844,5013,336164,120106,54363
"2018-01-01 00:00:00,000","Punta Indio","655",81783,17497,1066,2135,25333,28610,3148,162849,53943,3201
"2018-01-01 00:00:00,000","Tres Lomas","847",22965,10977,7916,8723,9987,8700,814,68795,18687,16639
"2018-01-01 00:00:00,000","Castelli","168",80627,23174,3461,6915,23021,26280,2787,169524,49301,10376
"2018-01-01 00:00:00,000","Daireaux","231",100201,27014,6023,12460,30871,32628,3881,214835,63499,18483
"2018-01-01 00:00:00,000","Puán","651",142273,42282,15606,20532,42307,44536,6094,315859,86843,36138
"2018-01-01 00:00:00,000","Alberti","021",16836,3849,1319,1862,6722,7119,719,38823,13841,3181
"2018-01-01 00:00:00,000","Coronel Suárez","203",142889,42794,13906,22979,59067,57925,6231,344649,116992,36885
"2018-01-01 00:00:00,000","Chacabuco","210",39396,11639,1740,5656,16705,16859,1470,93619,33564,7396
"2018-01-01 00:00:00,000","General Pinto","351",69082,19674,5236,7468,23075,27837,2582,159716,50912,12704
"2018-01-01 00:00:00,000","Navarro","574",61949,23578,2958,5675,22380,24338,1952,144788,46718,8633
"2018-01-01 00:00:00,000","Presidente Perón","648",1303,258,104,137,418,587,45,3021,1005,241
"2018-01-01 00:00:00,000","Necochea","581",85203,19817,4226,6523,29573,31821,3724,183135,61394,10749
"2018-01-01 00:00:00,000","25 de Mayo","854",134215,39119,3850,18045,60367,57770,5913,316682,118137,21895
"2018-01-01 00:00:00,000","Patagones","602",144038,36920,15654,23698,48790,55084,6253,336731,103874,39352
"2018-01-01 00:00:00,000","Saavedra","700",85173,26435,5408,9826,26787,28680,3697,187899,55467,15234
"2018-01-01 00:00:00,000","Maipú","511",104367,21428,5923,4852,32305,35020,4710,211320,67325,10775
"2018-01-01 00:00:00,000","Berisso","098",1840,138,633,71,551,534,57,3807,1085,704
"2018-01-01 00:00:00,000","Florencio Varela","274",2723,683,45,218,799,870,128,5537,1669,263
"2018-01-01 00:00:00,000","Tapalqué","798",171806,30940,1646,6915,48221,54859,6971,327996,103080,8561
"2018-01-01 00:00:00,000","Ayacucho","042",351708,74545,16957,29336,113889,121435,13627,729043,235324,46293
"2018-01-01 00:00:00,000","Lobería","476",96972,26890,11562,8729,40154,39356,4706,227571,79510,20291
"2018-01-01 00:00:00,000","San Andrés de Giles","728",22745,9617,1873,7175,9710,10511,1127,63559,20221,9048
"2018-01-01 00:00:00,000","Pehuajó","609",107740,33035,19089,18075,42480,44108,4088,270243,86588,37164
"2018-01-01 00:00:00,000","Tandil","791",138588,50253,18851,18092,45796,54977,5123,340861,100773,36943
"2018-01-01 00:00:00,000","Hipólito Yrigoyen","406",29930,11339,15475,6835,14923,15037,974,94627,29960,22310
"2018-01-01 00:00:00,000","San Pedro","770",16688,6391,2316,7687,9979,8686,826,51280,18665,10003
"2018-01-01 00:00:00,000","Bolívar","105",175922,52329,7784,23835,63062,67502,8424,403298,130564,31619
"2018-01-01 00:00:00,000","General Alvarado","280",26049,9468,1619,5338,10391,9999,1171,63643,20390,6957
"2018-01-01 00:00:00,000","José C. Paz","412",59,34,40,14,49,22,4,195,71,54
"2018-01-01 00:00:00,000","General Belgrano","301",63530,18975,3636,7863,22096,23625,2952,144206,45721,11499
"2018-01-01 00:00:00,000","Bragado","112",40863,8550,2172,2856,15976,16186,1697,88510,32162,5028
"2018-01-01 00:00:00,000","San Antonio de Areco","735",12161,3263,1594,1413,5610,5520,615,30086,11130,3007
"2018-01-01 00:00:00,000","General Las Heras","329",39387,12002,1921,2732,12425,15100,1576,87818,27525,4653
"2018-01-01 00:00:00,000","Guaminí","399",109124,42039,16705,17833,45774,51987,4444,294119,97761,34538
"2018-01-01 00:00:00,000","General Alvear","287",141895,46185,4246,12565,38998,45195,5695,300976,84193,16811
"2018-01-01 00:00:00,000","San Cayetano","742",55735,10795,973,9267,21856,22246,2316,123578,44102,10240
"2018-01-01 00:00:00,000","Las Flores","455",147894,27155,2280,5623,36780,43459,6659,276529,80239,7903
"2018-01-01 00:00:00,000","Benito Juárez","084",210354,40306,10453,10516,67211,71197,8975,422998,138408,20969
"2018-01-01 00:00:00,000","Lezama","466",864,143,8,8,279,328,33,1712,607,16
"2018-01-01 00:00:00,000","Azul","049",241076,69531,11425,25157,84307,89714,10676,537293,174021,36582
"2018-01-01 00:00:00,000","San Fernando","749",3464,705,67,172,920,966,154,6494,1886,239
"2018-01-01 00:00:00,000","San Nicolás","763",8608,2118,79,921,2541,2673,309,17381,5214,1000
"2018-01-01 00:00:00,000","Berazategui","091",869,269,964,290,280,230,44,2896,510,1254
"2018-01-01 00:00:00,000","Leandro N. Alem","462",31380,11714,750,5939,11411,12283,1415,75764,23694,6689
"2018-01-01 00:00:00,000","Junín","413",34569,10034,916,3657,14335,14458,2233,80325,28793,4573
"2018-01-01 00:00:00,000","Lincoln","469",186317,52750,11403,19807,73610,75851,8617,430596,149461,31210
"2018-01-01 00:00:00,000","General La Madrid","322",188505,52861,13869,13960,60863,66205,7380,408985,127068,27829
"2018-01-01 00:00:00,000","General Arenales","294",14810,3019,128,1700,6231,6769,631,33826,13000,1828
"2018-01-01 00:00:00,000","General Lavalle","336",89560,19696,4778,7807,29234,30866,4058,187631,60100,12585
"2018-01-01 00:00:00,000","Cañuelas","134",57969,15179,1130,2163,16796,20278,2682,119679,37074,3293
"2018-01-01 00:00:00,000","Balcarce","063",117016,42170,14027,15209,49233,49660,6539,294281,98893,29236
"2018-01-01 00:00:00,000","La Matanza","427",756,294,41,88,256,296,43,1814,552,129
"2018-01-01 00:00:00,000","General Guido","308",113416,18325,2624,3979,33910,37354,4416,217468,71264,6603
"2018-01-01 00:00:00,000","Baradero","070",15613,6028,867,5239,8582,7914,673,44248,16496,6106
"2018-01-01 00:00:00,000","José M. Ezeiza","270",680,140,94,85,302,312,37,1660,614,179
"2018-01-01 00:00:00,000","Salliqueló","721",21738,9021,9474,11022,10498,8490,1064,69299,18988,20496
"2018-01-01 00:00:00,000","Arrecifes","077",18426,3882,1410,3459,9041,12680,929,53466,21721,4869
"2018-01-01 00:00:00,000","Zárate","882",6919,4161,1323,2504,4071,3970,515,23362,8041,3827
"2018-01-01 00:00:00,000","Luján","497",14463,5938,358,1571,4670,5492,518,33832,10162,1929
"2018-01-01 00:00:00,000","Tornquist","819",92835,36689,7276,15241,24887,28028,3805,211902,52915,22517
"2018-01-01 00:00:00,000","La Plata","441",22083,7566,751,2843,11651,10324,984,54875,21975,3594
"2018-01-01 00:00:00,000","San Vicente","778",27764,5763,692,1348,8514,10035,1121,56758,18549,2040
"2018-01-01 00:00:00,000","Saladillo","707",96821,35410,3572,24011,42033,41620,4605,247659,83653,27583
"2018-01-01 00:00:00,000","Lobos","483",59941,24165,1686,6566,27306,28788,2209,152143,56094,8252
"2018-01-01 00:00:00,000","Laprida","448",156339,38531,12589,14045,47313,51084,6314,329986,98397,26634
"2018-01-01 00:00:00,000","Salto","714",16668,4509,774,2879,9259,9045,589,43509,18304,3653
"2018-01-01 00:00:00,000","Tordillo","812",53023,15632,3568,6531,22111,21090,2357,123291,43201,10099
"2018-01-01 00:00:00,000","Exaltación de la Cruz","266",9414,3347,122,1724,3482,3682,441,22412,7164,1846
"2018-01-01 00:00:00,000","Bahía Blanca","056",44213,16237,2227,7602,14577,14553,2199,101584,29130,9829
"2018-01-01 00:00:00,000","Campana","126",7815,1357,375,884,2277,2220,366,15237,4497,1259
"2017-01-01 00:00:00,000","Coronel Dorrego","189",84039,32996,12498,12533,28104,29026,3238,203356,57130,25031
"2017-01-01 00:00:00,000","La Plata","441",22077,8089,879,1614,10931,9577,1063,52876,20508,2493
"2017-01-01 00:00:00,000","La Matanza","427",868,292,77,30,116,171,29,1638,287,107
"2017-01-01 00:00:00,000","Pehuajó","609",103361,31014,18303,15390,42976,41790,3953,255601,84766,33693
"2017-01-01 00:00:00,000","9 de Julio","588",119718,39877,5060,12488,45569,51379,4122,284023,96948,17548
"2017-01-01 00:00:00,000","General Viamonte","385",51534,13223,1263,6520,21617,21455,2402,117852,43072,7783
"2017-01-01 00:00:00,000","Capitán Sarmiento","140",52,30,42,14,57,16,3,173,73,56
"2017-01-01 00:00:00,000","Las Flores","455",148585,33566,1729,9675,45980,52097,6847,304596,98077,11404
"2017-01-01 00:00:00,000","General Belgrano","301",60059,20926,3407,6737,22007,24043,2932,142147,46050,10144
"2017-01-01 00:00:00,000","General Guido","308",111716,20540,1851,4629,33343,36994,4309,217033,70337,6480
"2017-01-01 00:00:00,000","General La Madrid","322",184259,58127,13329,17658,63539,69149,6975,418646,132688,30987
"2017-01-01 00:00:00,000","Laprida","448",153207,44268,11301,16514,50564,54784,6047,340905,105348,27815
"2017-01-01 00:00:00,000","Olavarría","595",300259,77021,14470,36376,107616,109298,13380,660102,216914,50846
"2017-01-01 00:00:00,000","Coronel Pringles","196",152674,38100,6447,14249,45971,52612,6506,323200,98583,20696
"2017-01-01 00:00:00,000","Coronel de Marina Leonardo Rosales","182",20375,6505,804,2934,4966,5617,906,42758,10583,3738
"2017-01-01 00:00:00,000","General Pueyrredón","357",17835,6354,4096,2957,5837,6916,872,45946,12753,7053
"2017-01-01 00:00:00,000","Exaltación de la Cruz","266",10050,2858,108,1104,3358,3581,563,21845,6939,1212
"2017-01-01 00:00:00,000","Necochea","581",80003,20041,6065,4872,26984,29921,3665,174488,56905,10937
"2017-01-01 00:00:00,000","Adolfo Gonzales Chaves","014",107036,28857,1813,6763,34993,36419,4969,222276,71412,8576
"2017-01-01 00:00:00,000","Florencio Varela","274",2588,590,36,210,788,818,124,5184,1606,246
"2017-01-01 00:00:00,000","Lobos","483",58338,23428,2807,6215,25150,26991,2113,146883,52141,9022
"2017-01-01 00:00:00,000","Marcos Paz","525",11865,4328,797,3167,4865,4711,350,29929,9576,3964
"2017-01-01 00:00:00,000","Escobar","252",2840,661,109,65,839,927,150,5679,1766,174
"2017-01-01 00:00:00,000","Lomas de Zamora","490",85,44,10,9,6,10,1,169,16,19
"2017-01-01 00:00:00,000","General Paz","343",61308,19510,1750,3410,18649,23551,2440,135520,42200,5160
"2017-01-01 00:00:00,000","Hipólito Yrigoyen","406",31181,12052,12621,7571,14412,14111,1089,92736,28523,20192
"2017-01-01 00:00:00,000","Luján","497",13573,4942,483,1642,4538,5225,597,31687,9763,2125
"2017-01-01 00:00:00,000","Mar Chiquita","518",138158,47312,3814,13416,45120,51098,6928,311824,96218,17230
"2017-01-01 00:00:00,000","General Juan Madariaga","315",109392,29679,9248,17177,37605,40647,4472,251262,78252,26425
"2017-01-01 00:00:00,000","Maipú","511",105155,22818,5016,6185,32948,34283,4881,212621,67231,11201
"2017-01-01 00:00:00,000","Guaminí","399",106660,38911,16597,22830,48519,51277,4564,292116,99796,39427
"2017-01-01 00:00:00,000","Magdalena","505",94667,19878,3661,6016,29128,32167,4419,192975,61295,9677
"2017-01-01 00:00:00,000","José M. Ezeiza","270",569,180,57,81,165,222,30,1361,387,138
"2017-01-01 00:00:00,000","General Arenales","294",15000,3178,119,1622,5912,5607,637,31770,11519,1741
"2017-01-01 00:00:00,000","Ensenada","245",258,49,185,85,90,70,9,726,160,270
"2017-01-01 00:00:00,000","General Lavalle","336",85128,19468,4088,5890,26115,28850,4010,176284,54965,9978
"2017-01-01 00:00:00,000","Leandro N. Alem","462",30739,10485,975,5491,10004,10540,1333,70103,20544,6466
"2017-01-01 00:00:00,000","Coronel Suárez","203",140932,46459,17173,22484,61919,59636,6185,352505,121555,39657
"2017-01-01 00:00:00,000","Junín","413",35935,9708,924,2198,15009,14942,2147,80796,29951,3122
"2017-01-01 00:00:00,000","Navarro","574",59331,23905,3618,6158,20605,22146,1859,139163,42751,9776
"2017-01-01 00:00:00,000","General Las Heras","329",38344,12387,1534,2918,12025,14064,1552,84863,26089,4452
"2017-01-01 00:00:00,000","General Pinto","351",68437,22040,3749,7062,26594,26777,2646,157488,53371,10811
"2017-01-01 00:00:00,000","Mercedes","532",35699,13124,2092,2692,11468,12461,1502,80031,23929,4784
"2017-01-01 00:00:00,000","Daireaux","231",98011,28930,7588,13029,31502,36419,3875,224271,67921,20617
"2017-01-01 00:00:00,000","General Alvear","287",145445,45623,5860,9382,45176,50427,5557,312721,95603,15242
"2017-01-01 00:00:00,000","Lincoln","469",181456,54901,11140,23983,67562,72172,8247,424071,139734,35123
"2017-01-01 00:00:00,000","Monte","547",56734,19104,4235,6369,19410,21979,2213,132613,41389,10604
"2017-01-01 00:00:00,000","Merlo","539",273,34,3,1,28,45,13,414,73,4
"2017-01-01 00:00:00,000","Dolores","238",76436,21516,4115,4671,25418,25401,3567,161107,50819,8786
"2017-01-01 00:00:00,000","General Alvarado","280",25657,6914,2029,4657,9204,9199,1097,58752,18403,6686
"2017-01-01 00:00:00,000","General Villegas","392",120606,48770,29142,30436,54501,53797,5136,341684,108298,59578
"2017-01-01 00:00:00,000","Lobería","476",91363,27995,10182,8358,35875,36436,3768,214538,72311,18540
"2017-01-01 00:00:00,000","Pila","630",131167,38396,2125,5782,40369,43259,5249,269237,83628,7907
"2017-01-01 00:00:00,000","Tapalqué","798",173470,36414,2366,10717,49669,55289,7203,340748,104958,13083
"2017-01-01 00:00:00,000","Berazategui","091",1024,316,615,766,256,245,73,3284,501,1381
"2017-01-01 00:00:00,000","Puán","651",135157,42122,14966,23147,42907,46932,6368,315624,89839,38113
"2017-01-01 00:00:00,000","Carlos Casares","147",71665,23538,7837,12817,25363,27479,2837,173652,52842,20654
"2017-01-01 00:00:00,000","Arrecifes","077",18227,6217,1442,5000,9227,12208,894,56196,21435,6442
"2017-01-01 00:00:00,000","Tornquist","819",92246,37181,7661,17801,28494,30737,3938,220301,59231,25462
"2017-01-01 00:00:00,000","Cañuelas","134",56881,15486,1024,2690,16627,19661,2242,117645,36288,3714
"2017-01-01 00:00:00,000","Punta Indio","655",77198,17730,882,2168,21529,25548,3593,152667,47077,3050
"2017-01-01 00:00:00,000","Castelli","168",79690,22689,2827,6966,21101,25208,3015,165603,46309,9793
"2017-01-01 00:00:00,000","Ayacucho","042",341701,85949,15569,32122,112554,120430,13898,730099,232984,47691
"2017-01-01 00:00:00,000","Saladillo","707",89174,35455,5374,19075,37785,39285,4510,232158,77070,24449
"2017-01-01 00:00:00,000","Tordillo","812",52427,18131,3695,6474,16953,19350,2449,121876,36303,10169
"2017-01-01 00:00:00,000","San Nicolás","763",8183,1756,75,968,2455,2749,334,16814,5204,1043
"2017-01-01 00:00:00,000","Benito Juárez","084",203804,44843,10701,10612,65250,70713,8654,420040,135963,21313
"2017-01-01 00:00:00,000","Ramallo","665",12082,4827,1648,3707,8560,8816,561,40457,17376,5355
"2017-01-01 00:00:00,000","Patagones","602",136231,38395,18069,23089,42949,48595,5851,318825,91544,41158
"2017-01-01 00:00:00,000","Capitán Sarmiento","140",5557,1911,97,622,2373,2424,358,13393,4797,719
"2017-01-01 00:00:00,000","Saavedra","700",82882,29257,5191,11886,30213,30451,3577,193695,60664,17077
"2017-01-01 00:00:00,000","Rojas","686",25442,8583,1876,7597,13418,12095,1006,68694,25513,9473
"2017-01-01 00:00:00,000","Balcarce","063",114369,44208,11429,14290,44453,45286,6939,281807,89739,25719
"2017-01-01 00:00:00,000","Suipacha","784",36834,11078,1191,3102,9588,11179,1442,76005,20767,4293
"2017-01-01 00:00:00,000","Carlos Tejedor","154",110951,35418,12218,17627,42259,42952,4699,266817,85211,29845
"2017-01-01 00:00:00,000","Roque Pérez","693",48207,11069,1620,3750,24507,24103,2164,115016,48610,5370
"2017-01-01 00:00:00,000","Rivadavia","679",56748,29155,19635,50427,38398,25144,2094,208347,63542,70062
"2017-01-01 00:00:00,000","Chacabuco","210",38254,11115,2143,5192,16390,16594,1491,91383,32984,7335
"2017-01-01 00:00:00,000","Baradero","070",13601,4598,1706,3333,5870,6427,616,36708,12297,5039
"2017-01-01 00:00:00,000","Bahía Blanca","056",43458,18679,2354,8310,13228,13692,2117,102302,26920,10664
"2017-01-01 00:00:00,000","San Pedro","770",14724,5353,1492,8240,8201,5805,762,42181,14006,9732
"2017-01-01 00:00:00,000","Carmen de Areco","161",31741,15152,2359,1994,11061,15316,1283,83161,26377,4353
"2017-01-01 00:00:00,000","Rauch","672",194369,48484,4960,11053,58629,65597,8208,398268,124226,16013
"2017-01-01 00:00:00,000","San Andrés de Giles","728",22227,9084,1723,4528,9822,11093,1276,61024,20915,6251
"2017-01-01 00:00:00,000","Azul","049",236675,77516,12020,21024,85222,91732,10530,541229,176954,33044
"2017-01-01 00:00:00,000","Tandil","791",131083,50536,10457,21885,43903,49849,5316,318975,93752,32342
"2017-01-01 00:00:00,000","Trenque Lauquen","826",122279,60641,33718,34268,40371,52332,3279,358849,92703,67986
"2017-01-01 00:00:00,000","San Vicente","778",28407,6337,929,1154,8131,9511,1467,57316,17642,2083
"2017-01-01 00:00:00,000","San Fernando","749",3348,418,142,79,809,981,110,6059,1790,221
"2017-01-01 00:00:00,000","Villarino","875",179132,64151,19700,25266,56681,61014,7806,418083,117695,44966
"2017-01-01 00:00:00,000","San Antonio de Areco","735",11250,2028,1281,1810,6005,4883,588,26723,10888,3091
"2017-01-01 00:00:00,000","Bragado","112",39123,10056,1505,4446,14153,14842,1543,86357,28995,5951
"2017-01-01 00:00:00,000","25 de Mayo","854",128894,38741,4013,18362,57583,59018,5395,313441,116601,22375
"2017-01-01 00:00:00,000","Adolfo Alsina","007",110054,39340,20584,23625,43596,41662,3898,280825,85258,44209
"2017-01-01 00:00:00,000","Alberti","021",15895,4148,531,1870,7858,7454,948,38300,15312,2401
"2017-01-01 00:00:00,000","Florentino Ameghino","277",52834,17301,6200,8780,20343,19980,2085,127160,40323,14980
"2017-01-01 00:00:00,000","Pellegrini","616",28788,11053,8989,12250,16080,11896,1033,85905,27976,21239
"2017-01-01 00:00:00,000","General Rodríguez","364",8149,2226,405,666,2381,3000,303,17749,5381,1071
"2017-01-01 00:00:00,000","Bolívar","105",174027,55685,8866,24558,58154,64426,8649,400637,122580,33424
"2017-01-01 00:00:00,000","Chivilcoy","224",36494,12952,2698,4388,14580,13608,1698,85446,28188,7086
"2017-01-01 00:00:00,000","Salto","714",16190,3718,560,3236,8972,8853,622,42032,17825,3796
"2017-01-01 00:00:00,000","Colón","175",15809,4741,412,1740,5354,5205,689,33801,10559,2152
"2017-01-01 00:00:00,000","Pergamino","623",47695,15157,4429,3699,17926,20052,2020,113104,37978,8128
"2017-01-01 00:00:00,000","San Cayetano","742",52611,12710,884,8116,20437,20360,2269,117310,40797,9000
"2017-01-01 00:00:00,000","Berisso","098",1918,234,552,110,537,490,62,3856,1027,662
"2017-01-01 00:00:00,000","Tres Arroyos","833",97536,29239,8487,10570,35592,38535,4123,227025,74127,19057
"2017-01-01 00:00:00,000","Pilar","638",1584,577,77,74,442,408,81,3209,850,151
"2017-01-01 00:00:00,000","Chascomús","218",174185,58732,4684,20359,56068,62491,7245,390187,118559,25043
"2017-01-01 00:00:00,000","Zárate","882",7199,2826,1181,2490,5623,5787,444,25714,11410,3671
"2017-01-01 00:00:00,000","Campana","126",7085,1004,409,572,1812,1946,358,13320,3758,981
"2017-01-01 00:00:00,000","Brandsen","119",63706,15037,1582,1964,19594,22622,3216,130749,42216,3546
"2017-01-01 00:00:00,000","Salliqueló","721",19433,9186,9668,11514,8991,6749,946,64245,15740,21182
"2017-01-01 00:00:00,000","Presidente Perón","648",822,119,13,41,207,275,33,1578,482,54
"2017-01-01 00:00:00,000","Tres Lomas","847",22325,10612,6210,10051,9121,8821,786,67626,17942,16261
"2011-01-01 00:00:00,000","Bragado","112",37347,8862,4041,3687,12949,13510,1737,82694,26459,7728
"2011-01-01 00:00:00,000","Bolívar","105",149155,47971,12597,30606,52784,53146,7228,353849,105930,43203
"2011-01-01 00:00:00,000","Coronel Pringles","196",108805,34544,7487,12825,40865,42334,6588,254917,83199,20312
"2011-01-01 00:00:00,000","Alberti","021",14784,4149,1308,2944,6750,5456,1281,35378,12206,4252
"2011-01-01 00:00:00,000","Pellegrini","616",24468,12348,17908,15602,9105,7364,1050,86104,16469,33510
"2011-01-01 00:00:00,000","Pehuajó","609",87350,27061,15061,21481,35191,34250,3777,223230,69441,36542
"2011-01-01 00:00:00,000","Las Flores","455",131943,31251,2330,6036,43921,46831,5931,271153,90752,8366
"2011-01-01 00:00:00,000","San Cayetano","742",42825,12769,2132,9625,16659,16768,2201,103088,33427,11757
"2011-01-01 00:00:00,000","Coronel Dorrego","189",68283,24835,7788,13672,25547,25908,3581,169975,51455,21460
"2011-01-01 00:00:00,000","Tornquist","819",56963,29458,10126,13722,17577,19389,4051,153098,36966,23848
"2011-01-01 00:00:00,000","San Antonio de Areco","735",10552,3141,1217,3139,4789,5336,621,29342,10125,4356
"2011-01-01 00:00:00,000","Mercedes","532",30539,12123,2509,4279,9449,11003,1526,72982,20452,6788
"2011-01-01 00:00:00,000","General Guido","308",111756,18563,3165,3154,31972,35891,4893,213313,67863,6319
"2011-01-01 00:00:00,000","Villarino","875",120958,45983,16769,20303,32440,34057,6483,278610,66497,37072
"2011-01-01 00:00:00,000","Tandil","791",111321,43027,17545,16635,44561,48030,4917,289505,92591,34180
"2011-01-01 00:00:00,000","Azul","049",204798,69413,13440,29413,81337,83655,11290,495664,164992,42853
"2011-01-01 00:00:00,000","Tigre","805",184,38,8,1,67,51,9,342,118,9
"2011-01-01 00:00:00,000","Coronel Suárez","203",103061,38185,20818,15945,47020,46653,6371,277686,93673,36763
"2011-01-01 00:00:00,000","General Lavalle","336",75433,21258,6174,9263,24271,25728,3347,166931,49999,15437
"2011-01-01 00:00:00,000","General Paz","343",52467,16380,2689,5068,16067,20350,2110,119414,36417,7757
"2011-01-01 00:00:00,000","La Matanza","427",819,303,19,199,239,179,40,1738,418,218
"2011-01-01 00:00:00,000","General Rodríguez","364",6472,2312,479,753,1910,2278,263,14835,4188,1232
"2011-01-01 00:00:00,000","San Vicente","778",27532,7413,1330,2303,8635,9764,1450,59556,18399,3633
"2011-01-01 00:00:00,000","Benito Juárez","084",156552,46043,14410,14170,52192,57865,7985,354890,110057,28580
"2011-01-01 00:00:00,000","9 de Julio","588",101328,32246,5472,13018,32738,41157,4767,239145,73895,18490
"2011-01-01 00:00:00,000","General Las Heras","329",32204,12257,3496,2550,11588,11591,1389,75078,23179,6046
"2011-01-01 00:00:00,000","Tordillo","812",49641,15920,3561,5813,17399,19106,2353,115500,36505,9374
"2011-01-01 00:00:00,000","Monte","547",55218,16735,4271,5529,22023,24326,2689,133094,46349,9800
"2011-01-01 00:00:00,000","Zárate","882",7585,3066,1610,1488,2165,2617,764,19747,4782,3098
"2011-01-01 00:00:00,000","San Pedro","770",14133,5135,9993,4724,5441,5171,738,45065,10612,14717
"2011-01-01 00:00:00,000","Laprida","448",118145,40195,13047,17229,48126,49439,6112,293606,97565,30276
"2011-01-01 00:00:00,000","Baradero","070",14639,5322,4797,6411,4818,4514,624,40821,9332,11208
"2011-01-01 00:00:00,000","Coronel de Marina Leonardo Rosales","182",16333,4787,1006,1357,4464,5214,895,34806,9678,2363
"2011-01-01 00:00:00,000","La Plata","441",20217,5877,1267,1370,9790,9077,968,47853,18867,2637
"2011-01-01 00:00:00,000","Necochea","581",70133,18902,8844,5497,21829,24878,4466,157598,46707,14341
"2011-01-01 00:00:00,000","Capitán Sarmiento","140",346,116,17,70,118,86,15,736,204,87
"2011-01-01 00:00:00,000","Olavarría","595",272387,79306,23913,37351,91849,98448,13745,623598,190297,61264
"2011-01-01 00:00:00,000","San Nicolás","763",7973,1527,204,1120,2666,2936,294,16990,5602,1324
"2011-01-01 00:00:00,000","Ensenada","245",224,81,193,60,67,53,12,676,120,253
"2011-01-01 00:00:00,000","Berisso","098",1074,159,1089,225,326,298,40,3183,624,1314
"2011-01-01 00:00:00,000","Merlo","539",311,45,11,6,51,78,16,545,129,17
"2011-01-01 00:00:00,000","General La Madrid","322",133808,49039,12964,16426,48860,49698,6680,318313,98558,29390
"2011-01-01 00:00:00,000","Guaminí","399",83291,32870,25932,21335,36229,36682,4905,241697,72911,47267
"2011-01-01 00:00:00,000","Junín","413",33607,9173,1373,4202,14732,14492,1598,78937,29224,5575
"2011-01-01 00:00:00,000","San Fernando","749",3772,806,287,198,1127,1335,154,7887,2462,485
"2011-01-01 00:00:00,000","Berazategui","091",2279,378,744,658,548,409,97,4974,957,1402
"2011-01-01 00:00:00,000","Escobar","252",2779,936,84,354,812,815,182,5965,1627,438
"2011-01-01 00:00:00,000","General Belgrano","301",57418,20460,6233,5519,17831,22624,3954,138832,40455,11752
"2011-01-01 00:00:00,000","Ayacucho","042",272061,65983,14898,36689,84623,95867,12278,593643,180490,51587
"2011-01-01 00:00:00,000","Bahía Blanca","056",23260,14728,1866,6892,7299,7301,1646,62994,14600,8758
"2011-01-01 00:00:00,000","Mar Chiquita","518",126628,43443,7213,9323,43936,48201,6413,289422,92137,16536
"2011-01-01 00:00:00,000","Roque Pérez","693",45929,11870,4723,6799,23299,20276,3049,112922,43575,11522
"2011-01-01 00:00:00,000","Tres Arroyos","833",88857,25286,16046,6965,34913,36030,3734,212948,70943,23011
"2011-01-01 00:00:00,000","Chivilcoy","224",36402,12301,3262,4997,13776,13303,1797,85365,27079,8259
"2011-01-01 00:00:00,000","25 de Mayo","854",121640,41761,8589,23859,47832,48036,8029,299950,95868,32448
"2011-01-01 00:00:00,000","Lobos","483",49267,19549,3746,7209,18861,19683,2076,121213,38544,10955
"2011-01-01 00:00:00,000","Tapalqué","798",151294,36377,4497,11547,54692,57068,7081,324932,111760,16044
"2011-01-01 00:00:00,000","Exaltación de la Cruz","266",9006,2772,126,1224,3096,3321,502,20272,6417,1350
"2011-01-01 00:00:00,000","Rojas","686",25989,7388,4086,3718,11088,11762,1146,65851,22850,7804
"2011-01-01 00:00:00,000","Carmen de Areco","161",29276,11856,3288,5152,8337,10554,1077,71757,18891,8440
"2011-01-01 00:00:00,000","Puán","651",82035,31488,12381,13937,25524,26802,4677,198122,52326,26318
"2011-01-01 00:00:00,000","General Alvarado","280",21738,7461,869,8941,7222,8020,1737,56786,15242,9810
"2011-01-01 00:00:00,000","Chascomús","218",168871,48509,6565,18529,50693,57699,8101,365973,108392,25094
"2011-01-01 00:00:00,000","Maipú","511",93660,20978,5308,7132,27294,31370,4397,194215,58664,12440
"2011-01-01 00:00:00,000","Rivadavia","679",37313,21742,19037,55898,29847,16910,1544,169354,46757,74935
"2011-01-01 00:00:00,000","General Villegas","392",101204,44522,34531,38487,49850,41915,4751,307325,91765,73018
"2011-01-01 00:00:00,000","Ramallo","665",10002,4785,2701,3245,5839,4030,436,29229,9869,5946
"2011-01-01 00:00:00,000","Navarro","574",56501,24515,4337,8069,16840,19218,2112,133970,36058,12406
"2011-01-01 00:00:00,000","Magdalena","505",81756,22025,3787,8164,27283,30185,3794,179896,57468,11951
"2011-01-01 00:00:00,000","Chacabuco","210",36343,11896,2822,7499,15451,14121,1472,88274,29572,10321
"2011-01-01 00:00:00,000","Castelli","168",58197,22574,4164,5884,16148,18554,2604,130531,34702,10048
"2011-01-01 00:00:00,000","Tres Lomas","847",21651,11307,7288,12124,9673,6824,712,66730,16497,19412
"2011-01-01 00:00:00,000","Carlos Tejedor","154",100163,36237,22650,20316,32753,33123,4060,249672,65876,42966
"2011-01-01 00:00:00,000","Florentino Ameghino","277",45474,13731,7077,4837,16382,17434,1981,107968,33816,11914
"2011-01-01 00:00:00,000","José M. Ezeiza","270",971,261,158,124,254,371,38,2294,625,282
"2011-01-01 00:00:00,000","Florencio Varela","274",2356,690,65,291,529,572,114,4660,1101,356
"2011-01-01 00:00:00,000","Punta Indio","655",72175,17512,1309,3455,19998,24849,3171,147320,44847,4764
"2011-01-01 00:00:00,000","Luján","497",12484,4724,664,1021,3039,4037,1069,28036,7076,1685
"2011-01-01 00:00:00,000","Patagones","602",75868,29357,19925,13115,23240,23448,3838,188999,46688,33040
"2011-01-01 00:00:00,000","General Pueyrredón","357",16889,8227,3442,1675,4988,6638,902,44411,11626,5117
"2011-01-01 00:00:00,000","Rauch","672",182015,42933,4333,14097,58058,65180,8159,381897,123238,18430
"2011-01-01 00:00:00,000","San Andrés de Giles","728",21005,7325,1795,5848,6666,8071,1091,53206,14737,7643
"2011-01-01 00:00:00,000","General Juan Madariaga","315",93698,30075,7820,14472,33616,35582,4261,221490,69198,22292
"2011-01-01 00:00:00,000","Arrecifes","077",14138,4421,2366,3867,7033,5836,809,37273,12869,6233
"2011-01-01 00:00:00,000","Campana","126",6888,1363,250,902,1771,2095,253,13846,3866,1152
"2011-01-01 00:00:00,000","Leandro N. Alem","462",29499,12279,2283,6408,9054,9377,1276,70499,18431,8691
"2011-01-01 00:00:00,000","Adolfo Alsina","007",71648,30229,18630,21725,26302,25316,3358,196222,51618,40355
"2011-01-01 00:00:00,000","Pergamino","623",38047,12462,4625,5381,15642,16848,1959,96170,32490,10006
"2011-01-01 00:00:00,000","Salto","714",15283,6285,2022,2976,8369,8483,685,44217,16852,4998
"2011-01-01 00:00:00,000","Dolores","238",77284,19865,5740,7149,27342,26815,3324,166992,54157,12889
"2011-01-01 00:00:00,000","Daireaux","231",79858,25293,9457,8545,23055,24412,3910,175887,47467,18002
"2011-01-01 00:00:00,000","Cañuelas","134",50376,14390,1340,2462,15713,18112,2556,107348,33825,3802
"2011-01-01 00:00:00,000","Brandsen","119",56004,14823,2235,4362,17946,21194,2356,122168,39140,6597
"2011-01-01 00:00:00,000","Marcos Paz","525",12109,7762,551,2860,2102,2663,314,28922,4765,3411
"2011-01-01 00:00:00,000","General Arenales","294",13322,3033,77,1344,3855,4691,658,27816,8546,1421
"2011-01-01 00:00:00,000","Trenque Lauquen","826",97721,46561,14950,24432,40032,41964,3583,271175,81996,39382
"2011-01-01 00:00:00,000","Balcarce","063",133569,40790,23749,17431,45326,49764,6414,321481,95090,41180
"2011-01-01 00:00:00,000","Salliqueló","721",16925,9016,11021,11215,5996,1965,791,52898,7961,22236
"2011-01-01 00:00:00,000","General Viamonte","385",45562,12582,1545,6597,14574,16134,2114,100668,30708,8142
"2011-01-01 00:00:00,000","Pila","630",133708,34646,3086,7764,41619,44911,6480,275506,86530,10850
"2011-01-01 00:00:00,000","Adolfo Gonzales Chaves","014",85636,22161,4057,5734,29688,32114,4483,186299,61802,9791
"2011-01-01 00:00:00,000","Saavedra","700",59913,19283,5959,9969,19892,21054,3261,140493,40946,15928
"2011-01-01 00:00:00,000","Pilar","638",1379,389,78,161,303,349,60,2765,652,239
"2011-01-01 00:00:00,000","General Alvear","287",116468,39781,5152,10527,40572,46273,5779,270253,86845,15679
"2011-01-01 00:00:00,000","Almirante Brown","028",210,39,1,10,30,57,14,388,87,11
"2011-01-01 00:00:00,000","Carlos Casares","147",58481,23854,11119,14748,19879,20023,3905,152153,39902,25867
"2011-01-01 00:00:00,000","General Pinto","351",60411,23887,5111,9127,18804,24271,2960,150038,43075,14238
"2011-01-01 00:00:00,000","Lobería","476",84154,30098,14092,12216,31078,31381,6261,209583,62459,26308
"2011-01-01 00:00:00,000","Colón","175",12419,2803,1479,2111,5436,5875,552,31114,11311,3590
"2011-01-01 00:00:00,000","Saladillo","707",79113,28897,5984,15119,33840,32656,4551,198976,66496,21103
"2011-01-01 00:00:00,000","Esteban Echeverría","260",170,23,16,7,51,58,18,350,109,23
"2011-01-01 00:00:00,000","Hipólito Yrigoyen","406",26554,11811,6429,14832,17226,10078,1212,80994,27304,21261
"2011-01-01 00:00:00,000","Lincoln","469",160949,53037,15902,21264,54922,59827,9125,379931,114749,37166
"2011-01-01 00:00:00,000","Capitán Sarmiento","140",5401,2946,253,1349,2794,2603,318,15473,5397,1602
"2011-01-01 00:00:00,000","Suipacha","784",32424,12891,2653,4001,8128,11917,1475,77278,20045,6654
